ajenar	ajeno
presumir	presumo
testimoniar	testimonio
desuerar	desuero
lagartear	lagarteo
subemplear	subempleo
entablar	entablo
sojuzgar	sojuzgo
desbotonar	desbotono
descuajar	descuajo
completar	completo
computar	computo
podar	podo
alegrar	alegro
fertilizar	fertilizo
elaborar	elaboro
sobrecumplir	sobrecumplo
frecuentar	frecuento
remontar	remonto
redimensionar	redimensiono
cocinar	cocino
desliar	deslío
desposar	desposo
empedrar	empiedro
conmemorar	conmemoro
infatuar	infatúo
considerar	considero
dolar	duelo
sobrevirar	sobreviro
espumar	espumo
chismar	chismo
desimantar	desimanto
presentir	presiento
chambear	chambeo
dilapidar	dilapido
aburujar	aburujo
derrochar	derrocho
acriminar	acrimino
achabacanar	achabacano
expoliar	expolio
ahuyentar	ahuyento
zurear	zureo
ceñir	ciño
repoblar	repueblo
preseleccionar	preselecciono
coadyuvar	coadyuvo
roer	roo
rebozar	rebozo
cumplir	cumplo
sombrear	sombreo
moscar	mosco
descartar	descarto
emerger	emerjo
ultimar	ultimo
enladrillar	enladrillo
subvalorar	subvaloro
esquilar	esquilo
recriar	recrío
visualizar	visualizo
descampar	descampo
achicharrar	achicharro
solidificar	solidifico
parodiar	parodio
recrear	recreo
desnaturalizar	desnaturalizo
motejar	motejo
invisibilizar	invisibilizo
televisar	televiso
sobreemplear	sobreempleo
traducir	traduzco
aburguesar	aburgueso
endemoniar	endemonio
argüir	arguyo
monear	moneo
resultar	resulto
linchar	lincho
embotellar	embotello
premeditar	premedito
nacionalizar	nacionalizo
descontratar	descontrato
conferenciar	conferencio
ojear	ojeo
ornar	orno
nalguear	nalgueo
estibar	estibo
fritar	frito
retardar	retardo
gestar	gesto
encular	enculo
desagraviar	desagravio
reverter	revierto
perpetrar	perpetro
afirmar	afirmo
ramonear	ramoneo
estancar	estanco
mediar	medio
desolidarizar	desolidarizo
verticalizar	verticalizo
reproducir	reproduzco
detallar	detallo
dictar	dicto
emperejilar	emperejilo
valuar	valúo
filmar	filmo
congeniar	congenio
equipar	equipo
departir	departo
reflejar	reflejo
vertebrar	vertebro
desenlazar	desenlazo
horripilar	horripilo
arrestar	arresto
encabronar	encabrono
intrincar	intrinco
acordar	acuerdo
tutear	tuteo
drogar	drogo
denotar	denoto
redactar	redacto
cocear	coceo
checar	checo
fornicar	fornico
triar	trío
consultar	consulto
intentar	intento
discordar	discuerdo
oficializar	oficializo
misionar	misiono
trasquilar	trasquilo
danzar	danzo
envidiar	envidio
cohechar	cohecho
sillar	sillo
enorgullecer	enorgullezco
experimentar	experimento
restregar	restriego
taconear	taconeo
aleccionar	alecciono
talar	talo
infraccionar	infracciono
desplegar	despliego
atribular	atribulo
enarbolar	enarbolo
adarvar	adarvo
recolectar	recolecto
masificar	masifico
perforar	perforo
polemizar	polemizo
hipar	hipo
teledirigir	teledirijo
esmaltar	esmalto
concelebrar	concelebro
revolver	revuelvo
patrocinar	patrocino
chapalear	chapaleo
antorchar	antorcho
promiscuar	promiscuo
refulgir	refuljo
girar	giro
mojar	mojo
precipitar	precipito
malherir	malhiero
eructar	eructo
ensamblar	ensamblo
irrespetar	irrespeto
morir	muero
refacturar	refacturo
pervertir	pervierto
repujar	repujo
hender	hiendo
decorar	decoro
arrejuntar	arrejunto
enmasillar	enmasillo
canear	caneo
hidratar	hidrato
acrisolar	acrisolo
felicitar	felicito
trazar	trazo
troncar	tronco
cascar	casco
circunscribir	circunscribo
comisariar	comisarío
limar	limo
aculebrar	aculebro
petrificar	petrifico
brochar	brocho
fardar	fardo
abañar	abaño
cobrar	cobro
precomprar	precompro
rembolsar	rembolso
resurgir	resurjo
pajear	pajeo
devaluar	devalúo
expansionar	expansiono
exacerbar	exacerbo
mercerizar	mercerizo
significar	significo
adyacer	adyazco
sincopar	sincopo
atrancar	atranco
empeller	empello
repensar	repienso
rozar	rozo
europeizar	europeizo
acorazar	acorazo
compaginar	compagino
mover	muevo
enjaular	enjaulo
admirar	admiro
crotorear	crotoreo
escabechar	escabecho
trasvasar	trasvaso
desbancar	desbanco
escriturar	escrituro
acoquinar	acoquino
resumir	resumo
moldear	moldeo
reencarnar	reencarno
acanalar	acanalo
pernoctar	pernocto
adujar	adujo
malvivir	malvivo
interdisciplinar	interdisciplino
indigestar	indigesto
saltar	salto
coser	coso
penar	peno
espirar	espiro
agusanar	agusano
aherrojar	aherrojo
aplaudir	aplaudo
helar	hielo
codear	codeo
hechizar	hechizo
rezongar	rezongo
rajar	rajo
prevalecer	prevalezco
seguir	sigo
contrastar	contrasto
reajustar	reajusto
encinar	encino
avezar	avezo
rezumar	rezumo
abarrotar	abarroto
triturar	trituro
alhajar	alhajo
admitir	admito
llamear	llameo
preservar	preservo
dentar	diento
turnar	turno
encontrar	encuentro
encumbrar	encumbro
apechar	apecho
acercar	acerco
vestir	visto
granjear	granjeo
implicar	implico
doctorar	doctoro
jugar	juego
descuajaringar	descuajaringo
reverdecer	reverdezco
achatarrar	achatarro
despintar	despinto
alabar	alabo
arar	aro
acabar	acabo
desincrustar	desincrusto
sobar	sobo
apachar	apacho
espaciar	espacio
rapear	rapeo
contentar	contento
revalorizar	revalorizo
afeitar	afeito
entenebrecer	entenebrezco
recapitular	recapitulo
pingar	pingo
desacomodar	desacomodo
alterar	altero
escoltar	escolto
desionizar	desionizo
mesurar	mesuro
despolitizar	despolitizo
gustar	gusto
invitar	invito
remedar	remedo
cohibir	cohíbo
cualificar	cualifico
excusar	excuso
acentuar	acentúo
privar	privo
embadurnar	embadurno
garapiñar	garapiño
inaugurar	inauguro
enviar	envío
trascribir	trascribo
redecir	redigo
trompear	trompeo
acular	aculo
prudenciar	prudencio
deliberar	delibero
gallear	galleo
satelizar	satelizo
aviar	avío
incriminar	incrimino
acetificar	acetifico
abandonar	abandono
invadir	invado
remitir	remito
pinzar	pinzo
derrocar	derroco
prejuiciar	prejuicio
sumergir	sumerjo
ennegrecer	ennegrezco
alongar	alongo
lastimar	lastimo
ensortijar	ensortijo
preguntar	pregunto
desplazar	desplazo
transmigrar	transmigro
fusionar	fusiono
tamborilear	tamborileo
desembozar	desembozo
difractar	difracto
revisitar	revisito
enjoyar	enjoyo
castigar	castigo
desarraigar	desarraigo
apatrullar	apatrullo
suavizar	suavizo
ensillar	ensillo
rondar	rondo
reevaluar	reevalúo
ahormar	ahormo
agrietar	agrieto
amodorrar	amodorro
chancletear	chancleteo
pausar	pauso
integrar	integro
parlotear	parloteo
redefinir	redefino
corromper	corrompo
reinar	reino
atiborrar	atiborro
lacear	laceo
desflecar	desfleco
desentonar	desentono
conservar	conservo
asimilar	asimilo
redimir	redimo
calmar	calmo
desdolarizar	desdolarizo
adurir	aduro
reflorecer	reflorezco
recocer	recuezo
amohinar	amohíno
internacionalizar	internacionalizo
autoproclamar	autoproclamo
malinterpretar	malinterpreto
palpitar	palpito
pivotar	pivoto
lloriquear	lloriqueo
meritar	merito
dificultar	dificulto
atrever	atrevo
mester	mesto
estreñir	estriño
neviscar	nevisco
hacinar	hacino
publicitar	publicito
rencontraer	rencontrao
brujulear	brujuleo
reprobar	repruebo
readaptar	readapto
tercerizar	tercerizo
negligir	neglijo
saludar	saludo
intimar	intimo
hispanizar	hispanizo
celar	celo
resincronizar	resincronizo
esclavizar	esclavizo
mariposear	mariposeo
normalizar	normalizo
faldear	faldeo
adoctrinar	adoctrino
patalear	pataleo
habilitar	habilito
canchar	cancho
blindar	blindo
davilar	davilo
atrasar	atraso
zarandear	zarandeo
subordinar	subordino
destinar	destino
espigar	espigo
aguijar	aguijo
compenetrar	compenetro
demostrar	demuestro
cristalizar	cristalizo
enlatar	enlato
nidificar	nidifico
ensayar	ensayo
multidisciplinar	multidisciplino
desapegar	desapego
trenzar	trenzo
ilusionar	ilusiono
desplatar	desplato
cinematografiar	cinematografío
retimbrar	retimbro
conversar	converso
herniar	hernio
tablar	tablo
alquilar	alquilo
estresar	estreso
deslucir	desluzco
rumorar	rumoro
cromar	cromo
abrochar	abrocho
desvivir	desvivo
encapotar	encapoto
desterrar	destierro
ordeñar	ordeño
dedear	dedeo
notar	noto
engrosar	engrueso
atender	atiendo
amainar	amaino
sombrar	sombro
farolear	faroleo
abastar	abasto
atestar	atiesto
hastiar	hastío
espinar	espino
abetunar	abetuno
deflagrar	deflagro
recombinar	recombino
atajar	atajo
telefonear	telefoneo
adjudicar	adjudico
cuitar	cuito
molestar	molesto
acogotar	acogoto
plastificar	plastifico
vincular	vinculo
carbonatar	carbonato
traspasar	traspaso
positivar	positivo
manumitir	manumito
viralizar	viralizo
elidir	elido
evidenciar	evidencio
rebatir	rebato
inventar	invento
trasplantar	trasplanto
confeccionar	confecciono
negar	niego
pulverizar	pulverizo
baremar	baremo
flaquear	flaqueo
extorsionar	extorsiono
extraditar	extradito
despeñar	despeño
colisionar	colisiono
purpurar	purpuro
guarecer	guarezco
supeditar	supedito
emplear	empleo
comparar	comparo
teclear	tecleo
tarascar	tarasco
incubar	incubo
hisopar	hisopo
ambicionar	ambiciono
enumerar	enumero
bridar	brido
saldar	saldo
preparar	preparo
afectar	afecto
obviar	obvio
reeditar	reedito
barloventear	barloventeo
aciemar	aciemo
privatizar	privatizo
castellanizar	castellanizo
festonear	festoneo
enamorar	enamoro
hurtar	hurto
enfriar	enfrío
revolar	revuelo
desacreditar	desacredito
deshabilitar	deshabilito
gemir	gimo
soplar	soplo
desinsectar	desinsecto
gravitar	gravito
aplacar	aplaco
deferir	defiero
empequeñecer	empequeñezco
enflaquecer	enflaquezco
ventosear	ventoseo
recubrir	recubro
hornear	horneo
balsear	balseo
derelinquir	derelinco
fortificar	fortifico
deslindar	deslindo
atemperar	atempero
parangonar	parangono
injerir	injiero
atracar	atraco
abnegar	abniego
taquillar	taquillo
balacear	balaceo
estomagar	estomago
aserruchar	aserrucho
palear	paleo
rotar	roto
trasformar	trasformo
abarracar	abarraco
traslucir	trasluzco
constelar	constelo
movilizar	movilizo
socarrar	socarro
asar	aso
expugnar	expugno
conjugar	conjugo
tensar	tenso
presenciar	presencio
reforestar	reforesto
barequear	barequeo
insumir	insumo
chapotear	chapoteo
pendenciar	pendencio
alistar	alisto
bromear	bromeo
marinar	marino
inmolar	inmolo
succionar	succiono
hallar	hallo
anudar	anudo
salariar	salario
bestializar	bestializo
parapetar	parapeto
declamar	declamo
repulir	repulo
volantear	volanteo
reordenar	reordeno
balbucir	balbuzco
picar	pico
asaetear	asaeteo
desgravar	desgravo
babear	babeo
sugestionar	sugestiono
exceder	excedo
amasar	amaso
negrecer	negrezco
varar	varo
captar	capto
surcir	surzo
asesinar	asesino
culturar	culturo
expeditar	expedito
compeler	compelo
desaprobar	desapruebo
fuñir	fuño
respetar	respeto
rehusar	rehúso
simultanear	simultaneo
jerarquizar	jerarquizo
abducir	abduzco
cecear	ceceo
mensurar	mensuro
desprevenir	desprevengo
aturar	aturo
chotear	choteo
expresar	expreso
macerar	macero
numerar	numero
acodar	acodo
atropellar	atropello
farandulear	faranduleo
colar	cuelo
emplazar	emplazo
fibrilar	fibrilo
ecualizar	ecualizo
chorrear	chorreo
estigmatizar	estigmatizo
reverberar	reverbero
curtir	curto
epitomar	epitomo
devengar	devengo
amoblar	amueblo
destrenzar	destrenzo
refractar	refracto
emberrenchinar	emberrenchino
autorregular	autorregulo
agasajar	agasajo
abaratar	abarato
compartir	comparto
rumbear	rumbeo
reticular	reticulo
emanar	emano
fraternizar	fraternizo
recompensar	recompenso
desatorar	desatoro
inyectar	inyecto
magnetizar	magnetizo
mear	meo
empeñar	empeño
criticar	critico
autogobernar	autogobierno
aplatanar	aplatano
boquear	boqueo
asfaltar	asfalto
libertar	liberto
relacionar	relaciono
planchar	plancho
chispar	chispo
fumigar	fumigo
procrear	procreo
guayar	guayo
agrupar	agrupo
trasferir	trasfiero
desaconsejar	desaconsejo
mecanografiar	mecanografío
piratear	pirateo
avinagrar	avinagro
configurar	configuro
reconcentrar	reconcentro
degradar	degrado
clamar	clamo
adamar	adamo
zorrear	zorreo
tamborear	tamboreo
finiquitar	finiquito
disgustar	disgusto
aquietar	aquieto
complementar	complemento
amartillar	amartillo
incumbir	incumbo
gaguear	gagueo
endentar	endiento
diseminar	disemino
galguear	galgueo
disuadir	disuado
armonizar	armonizo
rechistar	rechisto
despiezar	despiezo
desfavorecer	desfavorezco
escaldar	escaldo
desmoldar	desmoldo
fugar	fugo
avivar	avivo
laborar	laboro
aclimatar	aclimato
coleguear	colegueo
desligar	desligo
desempolvar	desempolvo
entonar	entono
arrecir	arrezco
envilecer	envilezco
prender	prendo
sitiar	sitio
taclear	tacleo
renderizar	renderizo
obligar	obligo
filetear	fileteo
infantilizar	infantilizo
embobar	embobo
premiar	premio
reelegir	reelijo
pagar	pago
desenmarañar	desenmaraño
adverar	advero
baratar	barato
refugiar	refugio
desmembrar	desmiembro
peatonalizar	peatonalizo
arrollar	arrollo
reaprender	reaprendo
descachar	descacho
agringar	agringo
encarrilar	encarrilo
estorbar	estorbo
bojar	bojo
idear	ideo
patronear	patroneo
consistir	consisto
injertar	injerto
despreocupar	despreocupo
emocionar	emociono
destornillar	destornillo
aligerar	aligero
contaminar	contamino
enfurruñar	enfurruño
grasar	graso
potenciar	potencio
trepidar	trepido
cercar	cerco
esfumar	esfumo
lagrimar	lagrimo
flanquear	flanqueo
mutar	muto
ocurrir	ocurro
victimar	victimo
huevear	hueveo
rivalizar	rivalizo
diamantar	diamanto
encharcar	encharco
escoriar	escorio
vitorear	vitoreo
vocalizar	vocalizo
recruzar	recruzo
consagrar	consagro
firmar	firmo
cundir	cundo
convalidar	convalido
aglomerar	aglomero
marcir	marzo
reabsorber	reabsorbo
trompicar	trompico
retroiluminar	retroilumino
impurificar	impurifico
coprotagonizar	coprotagonizo
abrumar	abrumo
afrontar	afronto
ostentar	ostento
cincelar	cincelo
conmocionar	conmociono
publicar	publico
bizquear	bizqueo
acordonar	acordono
enfrenar	enfreno
engranar	engrano
estrangular	estrangulo
flirtear	flirteo
reasegurar	reaseguro
aflorar	afloro
popularizar	popularizo
criar	crío
desinfectar	desinfecto
cementar	cemento
eslabonar	eslabono
alardear	alardeo
puchar	pucho
descomprimir	descomprimo
omitir	omito
estoquear	estoqueo
lamer	lamo
sodomizar	sodomizo
quintar	quinto
acunar	acuno
aclamar	aclamo
embarcar	embarco
gañir	gaño
sacudir	sacudo
decolar	decolo
bucear	buceo
comisquear	comisqueo
artesonar	artesono
chaquetear	chaqueteo
saturar	saturo
barbar	barbo
cristianizar	cristianizo
ratonar	ratono
encintar	encinto
entrejuntar	entrejunto
vegetalizar	vegetalizo
sisar	siso
abuchear	abucheo
desprogramar	desprogramo
engrupir	engrupo
predestinar	predestino
apurar	apuro
silbar	silbo
pincelar	pincelo
fervorizar	fervorizo
diluviar	diluvio
trasmigrar	trasmigro
mosquear	mosqueo
arremangar	arremango
forjar	forjo
discar	disco
afligir	aflijo
estafar	estafo
resucitar	resucito
reconducir	reconduzco
datar	dato
discurrir	discurro
encapsular	encapsulo
enriquecer	enriquezco
tachar	tacho
instigar	instigo
erotizar	erotizo
despreciar	desprecio
licitar	licito
caminar	camino
ofuscar	ofusco
corporeizar	corporeizo
desempacar	desempaco
calcificar	calcifico
descarbonatar	descarbonato
acartonar	acartono
judaizar	judaizo
soberbiar	soberbio
hackear	hackeo
mutilar	mutilo
zurrar	zurro
arrimar	arrimo
orear	oreo
eludir	eludo
reembolsar	reembolso
marcar	marco
aliñar	aliño
intranquilizar	intranquilizo
mimeografiar	mimeografío
vehiculizar	vehiculizo
cotejar	cotejo
domesticar	domestico
apostrofar	apostrofo
vociferar	vocifero
ominar	omino
expender	expendo
borbollar	borbollo
vibrar	vibro
ascender	asciendo
electrocutar	electrocuto
contraindicar	contraindico
ideologizar	ideologizo
acañonear	acañoneo
localizar	localizo
comerciar	comercio
descongestionar	descongestiono
cometer	cometo
desconsolar	desconsuelo
balancear	balanceo
flechar	flecho
irrogar	irrogo
encaprichar	encapricho
facetar	faceto
escandir	escando
descascarar	descascaro
incautar	incauto
republicar	republico
desfallecer	desfallezco
catitear	catiteo
dramatizar	dramatizo
salvar	salvo
culpabilizar	culpabilizo
engomar	engomo
nulificar	nulifico
gotear	goteo
anotar	anoto
tecnificar	tecnifico
crear	creo
punir	puno
catalanizar	catalanizo
entrabar	entrabo
corroer	corroo
remilgar	remilgo
reñir	riño
sazonar	sazono
coproducir	coproduzco
redundar	redundo
sentenciar	sentencio
cabalgar	cabalgo
aliar	alío
grabar	grabo
apachurrar	apachurro
descentrar	descentro
tirar	tiro
relampaguear	relampagueo
producir	produzco
gritar	grito
malpensar	malpienso
tiritar	tirito
zancadillear	zancadilleo
entibiar	entibio
reaprovechar	reaprovecho
inflamar	inflamo
agarrar	agarro
abigarrar	abigarro
desmigajar	desmigajo
permutar	permuto
sonrojar	sonrojo
machar	macho
novar	novo
merodear	merodeo
desideologizar	desideologizo
escopetar	escopeto
desosar	deshueso
abrazar	abrazo
clavetear	claveteo
aristocratizar	aristocratizo
revolear	revoleo
descender	desciendo
embeber	embebo
mitificar	mitifico
planear	planeo
repugnar	repugno
abatanar	abatano
indiciar	indicio
abuñolar	abuñuelo
congelar	congelo
profundizar	profundizo
juzgar	juzgo
recopilar	recopilo
decepcionar	decepciono
consonar	consueno
salvaguardar	salvaguardo
fosilizar	fosilizo
henchir	hincho
bizcochar	bizcocho
encandilar	encandilo
prohibir	prohíbo
rasguñar	rasguño
azafranar	azafrano
transliterar	translitero
reinterpretar	reinterpreto
granular	granulo
correar	correo
auspiciar	auspicio
reeducar	reeduco
barnizar	barnizo
estereotipar	estereotipo
centrar	centro
estrujar	estrujo
promiscuir	promiscuo
puntear	punteo
achinar	achino
trasparentar	trasparento
chantajear	chantajeo
despampanar	despampano
trinchar	trincho
enzarzar	enzarzo
alear	aleo
alucinar	alucino
deleitar	deleito
vandalizar	vandalizo
horizontalizar	horizontalizo
concatenar	concateno
amurallar	amurallo
pepenar	pepeno
comportar	comporto
separar	separo
somatizar	somatizo
martillar	martillo
prosperar	prospero
quitar	quito
señalar	señalo
monitorear	monitoreo
arriesgar	arriesgo
mentir	miento
desmandar	desmando
asolear	asoleo
embriagar	embriago
enemistar	enemisto
intrigar	intrigo
desbastar	desbasto
aseverar	asevero
caricaturizar	caricaturizo
moblar	mueblo
gandulear	ganduleo
panificar	panifico
aguapar	aguapo
patentar	patento
despanzurrar	despanzurro
remecer	remezo
cruzar	cruzo
sosegar	sosiego
monetarizar	monetarizo
clonar	clono
sublimar	sublimo
satinar	satino
azulear	azuleo
recoger	recojo
abrotoñar	abrotoño
lamber	lambo
robustecer	robustezco
esponjar	esponjo
turistear	turisteo
anegar	aniego
engastar	engasto
rentar	rento
herir	hiero
autenticar	autentico
matasellar	matasello
extraviar	extravío
paginar	pagino
consignar	consigno
guarnecer	guarnezco
aojar	aojo
estrellar	estrello
churruscar	churrusco
abuzar	abuzo
enripiar	enripio
ahilar	ahílo
valorar	valoro
cilindrar	cilindro
luchar	lucho
bufonear	bufoneo
agrisar	agriso
acairelar	acairelo
cronometrar	cronometro
lubricar	lubrico
sucumbir	sucumbo
escurrir	escurro
remolonear	remoloneo
descollar	descuello
transcender	transciendo
rebuscar	rebusco
emparejar	emparejo
tapar	tapo
escamar	escamo
adoquinar	adoquino
consumar	consumo
blofear	blofeo
runrunear	runruneo
persuadir	persuado
graficar	grafico
actualizar	actualizo
acantonar	acantono
entornillar	entornillo
surfear	surfeo
intoxicar	intoxico
cuantiar	cuantío
agujar	agujo
chismear	chismeo
devolver	devuelvo
encanallar	encanallo
traslapar	traslapo
fajar	fajo
enmadrar	enmadro
desahuciar	desahucio
engrilletar	engrilleto
guiñar	guiño
desbandar	desbando
recepcionar	recepciono
colmar	colmo
arrullar	arrullo
gastar	gasto
hojaldrar	hojaldro
acompasar	acompaso
evacuar	evacúo
guindar	guindo
tutelar	tutelo
disonar	disueno
solubilizar	solubilizo
repudiar	repudio
asentar	asiento
entropezar	entropiezo
descachimbar	descachimbo
aparentar	aparento
barritar	barrito
torrar	torro
corresponsabilizar	corresponsabilizo
revertir	revierto
fulminar	fulmino
tapizar	tapizo
maldecir	maldigo
entredecir	entredigo
descansar	descanso
mellar	mello
entrelazar	entrelazo
arromar	arromo
colegir	colijo
asaltar	asalto
estilar	estilo
aparecer	aparezco
refinanciar	refinancio
guionar	guiono
perecer	perezco
bandear	bandeo
insertar	inserto
escribir	escribo
contestar	contesto
recalar	recalo
monedar	monedo
retranquear	retranqueo
reasentar	reasiento
enyerbar	enyerbo
resetear	reseteo
desmadejar	desmadejo
desenrollar	desenrollo
ejercer	ejerzo
amanecer	amanezco
despoblar	despueblo
escardar	escardo
divertir	divierto
purificar	purifico
engendrar	engendro
abacorar	abacoro
desestimular	desestimulo
condensar	condenso
desarrollar	desarrollo
candidatear	candidateo
liderar	lidero
zarpar	zarpo
tesar	teso
ultrajar	ultrajo
peinar	peino
carcomer	carcomo
observar	observo
otoñar	otoño
costar	cuesto
descapitalizar	descapitalizo
duchar	ducho
desregular	desregulo
cubicar	cubico
manotear	manoteo
oscilar	oscilo
cintar	cinto
acertar	acierto
contrapesar	contrapeso
humillar	humillo
desmemoriar	desmemorio
cuñar	cuño
pilotar	piloto
preconocer	preconozco
joder	jodo
arrodillar	arrodillo
camelar	camelo
escorar	escoro
alinear	alineo
periclitar	periclito
almorzar	almuerzo
desear	deseo
asistir	asisto
descalzar	descalzo
averiguar	averiguo
desrabotar	desraboto
caligrafiar	caligrafío
chiflar	chiflo
expirar	expiro
gesticular	gesticulo
acardenalar	acardenalo
apesadumbrar	apesadumbro
dispar	dispo
perrear	perreo
desengañar	desengaño
posibilitar	posibilito
fomentar	fomento
resalir	resalo
concursar	concurso
confrontar	confronto
reemitir	reemito
osificar	osifico
aplanar	aplano
ensopar	ensopo
reinventar	reinvento
conferir	confiero
modularizar	modularizo
zanjar	zanjo
fruncir	frunzo
enseñar	enseño
decebir	decibo
escandalizar	escandalizo
efundir	efundo
yodurar	yoduro
ritmar	ritmo
confesar	confieso
pasar	paso
empadronar	empadrono
salpresar	salpreso
hibernar	hiberno
subsistir	subsisto
descodificar	descodifico
declinar	declino
gafar	gafo
serrar	sierro
apestar	apesto
incardinar	incardino
imantar	imanto
acrianzar	acrianzo
coquetear	coqueteo
espejear	espejeo
secuenciar	secuencio
golpear	golpeo
rugir	rujo
agradar	agrado
vivificar	vivifico
emparedar	emparedo
acosar	acoso
estallar	estallo
sulfurar	sulfuro
enclavar	enclavo
exasperar	exaspero
denegar	deniego
euskaldunizar	euskaldunizo
subtitular	subtitulo
dimanar	dimano
raer	rao
servir	sirvo
maniatar	maniato
exulcerar	exulcero
investir	invisto
farrear	farreo
fichar	ficho
desnortar	desnorto
resplandecer	resplandezco
gatillar	gatillo
fintar	finto
reconocer	reconozco
hachar	hacho
segundar	segundo
carenar	careno
merengar	merengo
desfinanciar	desfinancio
adentrar	adentro
metamorfosear	metamorfoseo
violar	violo
envainar	envaino
apalancar	apalanco
delirar	deliro
judicializar	judicializo
indagar	indago
subdividir	subdivido
embrutecer	embrutezco
infectar	infecto
frentear	frenteo
trasponer	traspongo
azotar	azoto
lacrimar	lacrimo
chapar	chapo
capitalizar	capitalizo
fermentar	fermento
turbar	turbo
desceñir	desciño
maznar	mazno
desvariar	desvarío
gorronear	gorroneo
encañonar	encañono
depauperar	depaupero
intrusar	intruso
armar	armo
bambolear	bamboleo
degollar	degüello
vigilar	vigilo
almohadillar	almohadillo
autentificar	autentifico
sulfatar	sulfato
samplear	sampleo
autonombrar	autonombro
facultar	faculto
inducir	induzco
secretear	secreteo
esbozar	esbozo
abanderar	abandero
predicar	predico
enfundar	enfundo
achar	acho
tatuar	tatúo
subrogar	subrogo
escapar	escapo
autoconcebir	autoconcibo
sacramentar	sacramento
disertar	diserto
tartamudear	tartamudeo
escalar	escalo
horadar	horado
solear	soleo
amontonar	amontono
tiznar	tizno
rodear	rodeo
mensajear	mensajeo
deserotizar	deserotizo
enseñorar	enseñoro
geminar	gemino
relatar	relato
baldar	baldo
glotonear	glotoneo
fincar	finco
balaguer	balaguo
aislar	aíslo
contrahacer	contrahago
profundar	profundo
remolinear	remolineo
aflojar	aflojo
madrugar	madrugo
pelear	peleo
reclamar	reclamo
andar	ando
uñar	uño
galvanizar	galvanizo
inundar	inundo
descafeinar	descafeíno
desprender	desprendo
transgredir	transgredo
timbrar	timbro
civilizar	civilizo
parasitar	parasito
presupuestar	presupuesto
formular	formulo
gangrenar	gangreno
echar	echo
aculturar	aculturo
azadonar	azadono
husmear	husmeo
desinformar	desinformo
mercantilizar	mercantilizo
nominalizar	nominalizo
mecanizar	mecanizo
delinquir	delinco
religar	religo
reargüir	rearguyo
desenchufar	desenchufo
despepitar	despepito
titular	titulo
incomunicar	incomunico
exonerar	exonero
acolar	acolo
metaforizar	metaforizo
hiperventilar	hiperventilo
recobrar	recobro
aspaventar	aspaviento
apostillar	apostillo
encostrar	encostro
descalabrar	descalabro
aguaitar	aguaito
continuar	continúo
caducar	caduco
notificar	notifico
decir	digo
deforestar	deforesto
enjabonar	enjabono
refanfinflar	refanfinflo
edulcorar	edulcoro
menospreciar	menosprecio
engramar	engramo
fulgurar	fulguro
salivar	salivo
entrar	entro
marchar	marcho
zuzar	zuzo
pellizcar	pellizco
guacarear	guacareo
pretender	pretendo
quintuplicar	quintuplico
reblandecer	reblandezco
pertenecer	pertenezco
apelmazar	apelmazo
autoinmolar	autoinmolo
escabullir	escabullo
evangelizar	evangelizo
domiciliar	domicilio
repetir	repito
informatizar	informatizo
inclinar	inclino
farfullar	farfullo
reenviar	reenvio
irritar	irrito
terraformar	terraformo
hospitalizar	hospitalizo
ficar	fico
suscribir	suscribo
mallar	mallo
generalizar	generalizo
temblequear	temblequeo
reequilibrar	reequilibro
embutir	embuto
motear	moteo
alburear	albureo
descontinuar	descontinúo
trabajar	trabajo
burbujear	burbujeo
veranear	veraneo
refrendar	refrendo
legalizar	legalizo
sustanciar	sustancio
visitar	visito
ministerializar	ministerializo
fulgir	fuljo
ionizar	ionizo
extrudir	extrudo
madurar	maduro
expiar	expío
enervar	enervo
abominar	abomino
conectar	conecto
trascurrir	trascurro
alfabetizar	alfabetizo
petardear	petardeo
supervisar	superviso
tumbar	tumbo
glorificar	glorifico
desadormecer	desadormezco
impartir	imparto
capturar	capturo
registrar	registro
colectivizar	colectivizo
perdurar	perduro
regañar	regaño
colchar	colcho
destronar	destrono
homogeneizar	homogeneizo
antedatar	antedato
basar	baso
llover	lluevo
coparticipar	coparticipo
pinchar	pincho
mancomunar	mancomuno
tostar	tuesto
bailar	bailo
desencabestrar	desencabestro
frenar	freno
incumplir	incumplo
auscultar	ausculto
brotar	broto
faltar	falto
actuar	actúo
encaramar	encaramo
infravalorar	infravaloro
toquetear	toqueteo
desenganchar	desengancho
monetizar	monetizo
camuflajear	camuflajeo
refrescar	refresco
enmoquetar	enmoqueto
destentar	destiento
correr	corro
soterrar	sotierro
dirimir	dirimo
fundamentar	fundamento
responder	respondo
juramentar	juramento
apabullar	apabullo
procurar	procuro
facilitar	facilito
revacunar	revacuno
variar	varío
propinar	propino
agigantar	agiganto
pasaportar	pasaporto
pontificar	pontifico
estabular	estabulo
arrobar	arrobo
dopar	dopo
baldear	baldeo
alejar	alejo
escalfar	escalfo
votar	voto
accidentar	accidento
deplorar	deploro
concesionar	concesiono
tematizar	tematizo
enternecer	enternezco
preceptuar	preceptúo
abanar	abano
lacerar	lacero
incentivar	incentivo
contemporizar	contemporizo
historiar	historío
palanquear	palanqueo
bastar	basto
encallecer	encallezco
pencar	penco
distar	disto
acensuar	acensúo
combar	combo
agraviar	agravio
preponderar	prepondero
colorir	coloro
languidecer	languidezco
amblar	amblo
tibiar	tibio
peritar	perito
veranar	verano
resinar	resino
abastardar	abastardo
aspirar	aspiro
partir	parto
cabildear	cabildeo
subalternar	subalterno
nadar	nado
dominar	domino
inquinar	inquino
ahijar	ahíjo
saquear	saqueo
triplicar	triplico
encolar	encolo
cosquillear	cosquilleo
aprovechar	aprovecho
desmigar	desmigo
descarboxilar	descarboxilo
proseguir	prosigo
agenciar	agencio
alertar	alerto
solazar	solazo
trapalear	trapaleo
adormecer	adormezco
puentear	puenteo
implosionar	implosiono
arengar	arengo
indultar	indulto
anatematizar	anatematizo
retocar	retoco
mendigar	mendigo
cachar	cacho
defraudar	defraudo
recomer	recomo
poder	puedo
conceder	concedo
hamacar	hamaco
holgar	huelgo
afanar	afano
sacar	saco
insuflar	insuflo
saponificar	saponifico
finir	fino
endurecer	endurezco
avenar	aveno
rellenar	relleno
medicalizar	medicalizo
estrenar	estreno
tornar	torno
egresar	egreso
animalizar	animalizo
magullar	magullo
vegetar	vegeto
encajonar	encajono
descomulgar	descomulgo
poseer	poseo
empipar	empipo
reimaginar	reimagino
dippear	dippeo
alivianar	aliviano
adversar	adverso
incendiar	incendio
encallar	encallo
mercar	merco
chamuscar	chamusco
desorganizar	desorganizo
desgobernar	desgobierno
coartar	coarto
pedorrear	pedorreo
excepcionar	excepciono
rebuznar	rebuzno
hospedar	hospedo
acoger	acojo
desquitar	desquito
conchabar	conchabo
exfoliar	exfolio
tatemar	tatemo
accionar	acciono
recapitalizar	recapitalizo
depreciar	deprecio
jalonar	jalono
descogollar	descogollo
apiolar	apiolo
resistir	resisto
choricear	choriceo
defoliar	defolio
confitar	confito
llavear	llaveo
manufacturar	manufacturo
flotar	floto
retozar	retozo
desenfocar	desenfoco
menoscabar	menoscabo
repercutir	repercuto
mirar	miro
textear	texteo
anatemizar	anatemizo
enfadar	enfado
desandar	desando
cuadriplicar	cuadriplico
embaucar	embauco
ofender	ofendo
demandar	demando
capolar	capolo
hacendar	haciendo
realzar	realzo
despabilar	despabilo
infernalizar	infernalizo
apretar	aprieto
arruinar	arruino
relamer	relamo
maximizar	maximizo
desternillar	desternillo
ayunar	ayuno
cambiar	cambio
engrandecer	engrandezco
damnificar	damnifico
fildear	fildeo
desparecer	desparezco
persistir	persisto
pestañar	pestaño
beber	bebo
columpiar	columpio
distorsionar	distorsiono
engarzar	engarzo
recauchutar	recauchuto
estandardizar	estandardizo
participar	participo
acicatear	acicateo
sobreexponer	sobreexpongo
amagar	amago
pallar	pallo
disgregar	disgrego
apostar	apuesto
embarrilar	embarrilo
embullar	embullo
recelar	recelo
alargar	alargo
anhelar	anhelo
abatir	abato
tronar	trueno
polarizar	polarizo
papar	papo
remarcar	remarco
exterminar	extermino
fungir	funjo
tropezar	tropiezo
descrismar	descrismo
destrozar	destrozo
exir	exo
mordisquear	mordisqueo
radicar	radico
frustrar	frustro
germinar	germino
ocultar	oculto
parpadear	parpadeo
llamar	llamo
infundir	infundo
espabilar	espabilo
violentar	violento
preciar	precio
hermanar	hermano
lonjear	lonjeo
trancar	tranco
esperar	espero
estatizar	estatizo
siluetear	silueteo
saborear	saboreo
alcanforar	alcanforo
escarnecer	escarnezco
estabilizar	estabilizo
antiguar	antiguo
lucrar	lucro
flambear	flambeo
recentralizar	recentralizo
demarcar	demarco
abarbetar	abarbeto
derrengar	derrengo
arruar	arrúo
frangir	franjo
ironizar	ironizo
humar	humo
gestionar	gestiono
sufragar	sufrago
acristalar	acristalo
aferrar	aferro
desenjabonar	desenjabono
deludir	deludo
exculpar	exculpo
calibrar	calibro
sincerar	sincero
copresidir	copresido
sentar	siento
demonizar	demonizo
relievar	relievo
pichar	picho
falsificar	falsifico
salpullir	salpullo
desahogar	desahogo
versar	verso
victimizar	victimizo
atrapar	atrapo
potencializar	potencializo
vaporar	vaporo
escaecer	escaezco
reflotar	refloto
follar	follo
desintoxicar	desintoxico
mandonear	mandoneo
liberar	libero
achocolatar	achocolato
regresar	regreso
recoser	recoso
ganar	gano
embuchar	embucho
ruar	rúo
congratular	congratulo
entender	entiendo
entintar	entinto
apelar	apelo
dejar	dejo
angular	angulo
gruñir	gruño
prefigurar	prefiguro
lustrar	lustro
crotorar	crotoro
amparar	amparo
reclinar	reclino
marear	mareo
autoimponer	autoimpongo
frotar	froto
necesitar	necesito
enhilar	enhilo
conceptuar	conceptúo
abobar	abobo
arrumbar	arrumbo
gambetear	gambeteo
merendar	meriendo
deprimir	deprimo
desvalijar	desvalijo
aduanar	aduano
perseverar	persevero
despiojar	despiojo
carecer	carezco
anochecer	anochezco
crucificar	crucifico
desojar	desojo
trasbordar	trasbordo
temer	temo
increpar	increpo
rumbar	rumbo
serenar	sereno
carnavalear	carnavaleo
rehuir	rehúyo
calentar	caliento
eclipsar	eclipso
puar	púo
allegar	allego
redecorar	redecoro
decretar	decreto
relumbrar	relumbro
sesear	seseo
conceptualizar	conceptualizo
dinamitar	dinamito
postensar	postenso
emitir	emito
enjaezar	enjaezo
abrillantar	abrillanto
derretir	derrito
devastar	devasto
recamar	recamo
aparejar	aparejo
aparcar	aparco
ladear	ladeo
arraigar	arraigo
discutir	discuto
abarcar	abarco
privilegiar	privilegio
desembalsar	desembalso
forcejear	forcejeo
desconcertar	desconcierto
cautelar	cautelo
romanzar	romanzo
computarizar	computarizo
escotar	escoto
desazonar	desazono
crujir	crujo
cuerpear	cuerpeo
abochornar	abochorno
argüendear	argüendeo
desfajar	desfajo
leudar	leudo
reconvertir	reconvierto
desosegar	desosiego
deambular	deambulo
interaccionar	interacciono
bloguear	blogueo
pringar	pringo
deparar	deparo
rapar	rapo
desplumar	desplumo
suscitar	suscito
desenvolver	desenvuelvo
autoabastecer	autoabastezco
avisar	aviso
empachar	empacho
conmutar	conmuto
desmejorar	desmejoro
apellidar	apellido
atinar	atino
desestacionalizar	desestacionalizo
ejemplarizar	ejemplarizo
destripar	destripo
circundar	circundo
fraccionar	fracciono
implementar	implemento
reedificar	reedifico
ajar	ajo
cobijar	cobijo
agujerar	agujero
atornillar	atornillo
viajar	viajo
desconfiar	desconfío
embargar	embargo
diafragmar	diafragmo
almagrar	almagro
desembalar	desembalo
reestrenar	reestreno
celestinear	celestineo
apuntar	apunto
cabrahigar	cabrahígo
pluralizar	pluralizo
engolar	engolo
extrapolar	extrapolo
caber	quepo
oprimir	oprimo
desforzar	desfuerzo
vacar	vaco
fiar	fío
desintegrar	desintegro
interdecir	interdigo
capitanear	capitaneo
malcriar	malcrío
amerizar	amerizo
concadenar	concadeno
regularizar	regularizo
terciar	tercio
acuñar	acuño
temblar	tiemblo
relegar	relego
dedicar	dedico
vinagrar	vinagro
encorsetar	encorseto
corretear	correteo
amarillecer	amarillezco
ablacionar	ablaciono
plisar	pliso
evanescer	evanesco
orbitar	orbito
reenganchar	reengancho
modular	modulo
reprimir	reprimo
desdramatizar	desdramatizo
estandarizar	estandarizo
comiscar	comisco
colorear	coloreo
videograbar	videograbo
enhestar	enhiesto
trucar	truco
demoler	demuelo
chochear	chocheo
guarachear	guaracheo
trastear	trasteo
desmilitarizar	desmilitarizo
deshonrar	deshonro
energizar	energizo
procrastinar	procrastino
apercibir	apercibo
fumblear	fumbleo
proletarizar	proletarizo
asignar	asigno
instrumentalizar	instrumentalizo
impregnar	impregno
desacertar	desacierto
neutralizar	neutralizo
pender	pendo
carbonizar	carbonizo
quejar	quejo
preocupar	preocupo
estampillar	estampillo
recabar	recabo
acompañar	acompaño
allanar	allano
descastar	descasto
ilustrar	ilustro
hipotecar	hipoteco
secuestrar	secuestro
brindar	brindo
narrar	narro
desenfundar	desenfundo
deformar	deformo
castañear	castañeo
reputar	reputo
vampirizar	vampirizo
estremecer	estremezco
latigar	latigo
despaturrar	despaturro
gerenciar	gerencio
abalanzar	abalanzo
ventear	venteo
birlar	birlo
recomendar	recomiendo
apuntillar	apuntillo
sobreproteger	sobreprotejo
jarrar	jarro
empalagar	empalago
modorrar	modorro
sarpullir	sarpullo
vislumbrar	vislumbro
sintetizar	sintetizo
perecear	pereceo
zabullir	zabullo
habituar	habitúo
subseguir	subsigo
apacentar	apaciento
lañar	laño
propiciar	propicio
boicotear	boicoteo
tocar	toco
causar	causo
imitar	imito
sobrentender	sobrentiendo
pautar	pauto
refunfuñar	refunfuño
hundir	hundo
acechar	acecho
desmoralizar	desmoralizo
diplomar	diplomo
apandar	apando
concretizar	concretizo
arrinconar	arrincono
tironear	tironeo
llenar	lleno
convivir	convivo
extender	extiendo
desviar	desvío
denominar	denomino
contar	cuento
coaligar	coaligo
revocar	revoco
encargar	encargo
descaminar	descamino
driblear	dribleo
peregrinar	peregrino
embromar	embromo
percutir	percuto
achuchar	achucho
silabear	silabeo
copular	copulo
despavorir	despavoro
mandar	mando
franquear	franqueo
reutilizar	reutilizo
blocar	bloco
desmirlar	desmirlo
adinerar	adinero
acostar	acuesto
enlazar	enlazo
desratizar	desratizo
acampanar	acampano
ovillar	ovillo
añadir	añado
desembrujar	desembrujo
desobedecer	desobedezco
contagiar	contagio
pintar	pinto
cuadrillar	cuadrillo
regocijar	regocijo
matizar	matizo
carear	careo
tarifar	tarifo
enconchar	enconcho
enchuflar	enchuflo
telar	telo
abovedar	abovedo
chasquear	chasqueo
enrocar	enroco
cultivar	cultivo
tambalear	tambaleo
invaginar	invagino
traspirar	traspiro
agazapar	agazapo
charlotear	charloteo
arroyar	arroyo
suspirar	suspiro
emunger	emunjo
rescindir	rescindo
trasudar	trasudo
enmascarar	enmascaro
erupcionar	erupciono
compilar	compilo
reescribir	reescribo
fracasar	fracaso
aforar	aforo
recusar	recuso
reinfundir	reinfundo
rasguear	rasgueo
descoyuntar	descoyunto
disociar	disocio
esnifar	esnifo
agonizar	agonizo
practicar	practico
liquenizar	liquenizo
igualar	igualo
opositar	oposito
enclaustrar	enclaustro
radiografiar	radiografío
verificar	verifico
rociar	rocío
equilibrar	equilibro
autografiar	autografío
desprestigiar	desprestigio
insistir	insisto
monopolizar	monopolizo
batir	bato
atascar	atasco
matematizar	matematizo
promocionar	promociono
encamisar	encamiso
cicatrizar	cicatrizo
golosear	goloseo
abejorrear	abejorreo
cauterizar	cauterizo
disparatar	disparato
doctrinar	doctrino
zumbar	zumbo
remansar	remanso
drenar	dreno
currar	curro
apriscar	aprisco
decrepitar	decrepito
chascar	chasco
mamar	mamo
despistar	despisto
destensar	destenso
barbechar	barbecho
falcacear	falcaceo
desenamorar	desenamoro
asilar	asilo
banquetear	banqueteo
codirigir	codirijo
protocolizar	protocolizo
recalentar	recaliento
lavar	lavo
regalar	regalo
acudir	acudo
flipar	flipo
espetar	espeto
pungir	punjo
alabear	alabeo
desbrozar	desbrozo
desamparar	desamparo
despotricar	despotrico
gargarizar	gargarizo
morder	muerdo
descuidar	descuido
enterrar	entierro
encarecer	encarezco
verbalizar	verbalizo
repavimentar	repavimento
torear	toreo
desmineralizar	desmineralizo
sobrar	sobro
adjetivar	adjetivo
conexionar	conexiono
fregar	friego
refinar	refino
aumentar	aumento
coexistir	coexisto
corrugar	corrugo
matricular	matriculo
foguear	fogueo
imanar	imano
oscurecer	oscurezco
interpolar	interpolo
chamullar	chamullo
nitrificar	nitrifico
reinstalar	reinstalo
pedir	pido
largar	largo
ejemplificar	ejemplifico
ruinar	ruino
likear	likeo
encizañar	encizaño
aburrar	aburro
cafichear	caficheo
lloviznar	llovizno
coimear	coimeo
alcantarillar	alcantarillo
inteligir	intelijo
eximir	eximo
lubrificar	lubrifico
cifrar	cifro
exudar	exudo
indemnizar	indemnizo
ahorquillar	ahorquillo
orlar	orlo
forrajear	forrajeo
engrapar	engrapo
aperturar	aperturo
socializar	socializo
duplicar	duplico
arder	ardo
mejorar	mejoro
anquilosar	anquiloso
pulimentar	pulimento
aproximar	aproximo
agremiar	agremio
propalar	propalo
apechugar	apechugo
borbotar	borboto
irradiar	irradio
proporcionar	proporciono
puñar	puño
descorazonar	descorazono
promediar	promedio
autogenerar	autogenero
mulger	muljo
aludir	aludo
preceder	precedo
bordear	bordeo
chistar	chisto
flagelar	flagelo
navegar	navego
organizar	organizo
reembarcar	reembarco
condescender	condesciendo
descolgar	descuelgo
libar	libo
estimular	estimulo
desinflar	desinflo
implorar	imploro
replantear	replanteo
laudar	laudo
chutar	chuto
canonizar	canonizo
desprivatizar	desprivatizo
empantalonar	empantalono
fijar	fijo
grapar	grapo
explosionar	explosiono
estregar	estrego
desengarzar	desengarzo
forestar	foresto
menguar	menguo
arguir	arguo
venerar	venero
desmesurar	desmesuro
dibujar	dibujo
anticuar	anticúo
aromar	aromo
respaldar	respaldo
reverenciar	reverencio
recudir	recudo
abrasar	abraso
ajuarar	ajuaro
repicar	repico
apoquinar	apoquino
desafiar	desafío
baquetear	baqueteo
testear	testeo
remar	remo
entrampar	entrampo
dudar	dudo
realizar	realizo
modelizar	modelizo
embozar	embozo
priorizar	priorizo
pespuntear	pespunteo
desempeñar	desempeño
asediar	asedio
acuchillear	acuchilleo
resquebrajar	resquebrajo
divisar	diviso
nevar	nievo
adosar	adoso
ajetrear	ajetreo
desconocer	desconozco
absterger	absterjo
abonar	abono
irrigar	irrigo
casar	caso
desescombrar	desescombro
ganguear	gangueo
documentar	documento
agriar	agrío
circular	circulo
endosar	endoso
ahechar	ahecho
domeñar	domeño
bancar	banco
amenazar	amenazo
desamortizar	desamortizo
extrañar	extraño
requebrar	requiebro
desmedir	desmido
deshumanizar	deshumanizo
selfiar	selfío
alienar	alieno
conminar	conmino
rimar	rimo
empalmar	empalmo
agudizar	agudizo
sugerir	sugiero
encubertar	encuberto
cooptar	coopto
escayolar	escayolo
trabar	trabo
castrar	castro
chinchar	chincho
tremolar	tremolo
enfebrecer	enfebrezco
desecar	deseco
agorar	agüero
desatinar	desatino
barajar	barajo
vejar	vejo
yantar	yanto
suprimir	suprimo
desfondar	desfondo
solar	suelo
agujerear	agujereo
desasear	desaseo
aducir	aduzco
guglear	gugleo
enfangar	enfango
deterger	deterjo
desgastar	desgasto
desenvainar	desenvaino
reaprovisionar	reaprovisiono
historizar	historizo
acrecentar	acreciento
gratinar	gratino
pololear	pololeo
enfatizar	enfatizo
enceguecer	enceguezco
obrar	obro
enlenzar	enlienzo
piafar	piafo
sobredorar	sobredoro
simplificar	simplifico
esquinar	esquino
capear	capeo
afiliar	afilio
embijar	embijo
moquear	moqueo
polvear	polveo
desentrenar	desentreno
embarrancar	embarranco
serigrafiar	serigrafío
trascender	trasciendo
substantivar	substantivo
tejar	tejo
ustedear	ustedeo
agrandar	agrando
atemorizar	atemorizo
culear	culeo
instrumentar	instrumento
trasmitir	trasmito
deshacer	deshago
despelucar	despeluco
silabar	silabo
pronunciar	pronuncio
enharinar	enharino
reavivar	reavivo
descongelar	descongelo
conglomerar	conglomero
cenar	ceno
deslizar	deslizo
embolsar	embolso
arponar	arpono
enjalbegar	enjalbego
curiosear	curioseo
amasijar	amasijo
sintonizar	sintonizo
manejar	manejo
artillar	artillo
viborear	viboreo
articular	articulo
barbear	barbeo
esquivar	esquivo
desarticular	desarticulo
acaudillar	acaudillo
descontar	descuento
desunir	desuno
querer	quiero
desarbolar	desarbolo
contraseñar	contraseño
chalar	chalo
rebautizar	rebautizo
vadear	vadeo
desmerecer	desmerezco
emigrar	emigro
empizarrar	empizarro
cegar	ciego
enfocar	enfoco
arrebatar	arrebato
anidar	anido
posicionar	posiciono
desdorar	desdoro
destejar	destejo
compartimentar	compartimento
tripular	tripulo
mancipar	mancipo
vaguear	vagueo
creer	creo
trampear	trampeo
repelar	repelo
marchitar	marchito
subscribir	subscribo
sabotear	saboteo
jotear	joteo
reasignar	reasigno
contornar	contorno
anexar	anexo
acorchar	acorcho
iterar	itero
desencadenar	desencadeno
señorear	señoreo
magnificar	magnifico
sobrecargar	sobrecargo
acerar	acero
interpretar	interpreto
envalentonar	envalentono
exilar	exilo
inscribir	inscribo
apuñar	apuño
abordar	abordo
humear	humeo
finar	fino
profesionalizar	profesionalizo
granar	grano
cachimbear	cachimbeo
escanciar	escancio
abastecer	abastezco
sobregirar	sobregiro
babosear	baboseo
infernar	infierno
excretar	excreto
solidar	solido
achantar	achanto
bachear	bacheo
mullir	mullo
repolitizar	repolitizo
degenerar	degenero
desfasar	desfaso
transpirar	transpiro
exhortar	exhorto
aptar	apto
desganar	desgano
acojinar	acojino
latinizar	latinizo
jabonar	jabono
deshidratar	deshidrato
decodificar	decodifico
remolinar	remolino
trovar	trovo
redensificar	redensifico
recaudar	recaudo
singar	singo
verdear	verdeo
coleccionar	colecciono
transitar	transito
aboyar	aboyo
pisotear	pisoteo
dislocar	disloco
dosificar	dosifico
acaecer	acaezco
palmear	palmeo
santiguar	santiguo
pavimentar	pavimento
invernar	invierno
estuchar	estucho
perseguir	persigo
descolonizar	descolonizo
subdelegar	subdelego
reexplicar	reexplico
ñoñear	ñoñeo
coescribir	coescribo
incoar	incoo
atacar	ataco
pignorar	pignoro
precisar	preciso
quietar	quieto
comedir	comido
afincar	afinco
googlear	googleo
desportillar	desportillo
empatizar	empatizo
vacunar	vacuno
reanudar	reanudo
expedientar	expediento
arabizar	arabizo
cartografiar	cartografío
huronear	huroneo
contrarrestrar	contrarrestro
substanciar	substancio
argentar	argento
ahorrar	ahorro
remojar	remojo
desheredar	desheredo
pestañear	pestañeo
reseñar	reseño
acortar	acorto
exorcizar	exorcizo
adolecer	adolezco
elucidar	elucido
calar	calo
empicotar	empicoto
desaprovechar	desaprovecho
pasear	paseo
avellanar	avellano
recrudecer	recrudeco
concertar	concierto
imperar	impero
humectar	humecto
empapelar	empapelo
demodular	demodulo
desordenar	desordeno
botar	boto
injuriar	injurio
tetar	teto
aparatar	aparato
innovar	innovo
agredir	agredo
transar	transo
fumar	fumo
canalizar	canalizo
rolar	rolo
arremedar	arremedo
atormentar	atormento
zapear	zapeo
culpar	culpo
pecar	peco
estirar	estiro
recitar	recito
deshinchar	deshincho
homenajear	homenajeo
globalizar	globalizo
hegemonizar	hegemonizo
barbotar	barboto
besar	beso
recolar	recuelo
doblar	doblo
interceder	intercedo
desinvertir	desinvierto
blasonar	blasono
entrecortar	entrecorto
amortecer	amortezco
trizar	trizo
embravecer	embravezco
valsar	valso
penetrar	penetro
rectificar	rectifico
desfilar	desfilo
garabatear	garabateo
desmotivar	desmotivo
condenar	condeno
idiotizar	idiotizo
amarar	amaro
lindar	lindo
negociar	negocio
desgarrar	desgarro
noviar	novio
identificar	identifico
cremar	cremo
fingir	finjo
mitigar	mitigo
resintonizar	resintonizo
chinchorrear	chinchorreo
toller	tollo
apedazar	apedazo
clicar	clico
empastar	empasto
descamisar	descamiso
apilar	apilo
cucharear	cuchareo
desaparecer	desaparezco
revolucionar	revoluciono
soltar	suelto
bisbisar	bisbiso
murmurar	murmuro
malparar	malparo
enmaderar	enmadero
enamoriscar	enamorisco
consumir	consumo
esparcir	esparzo
existimar	existimo
piropear	piropeo
empapar	empapo
encofrar	encofro
grietar	grieto
nominar	nomino
desenfilar	desenfilo
enclavijar	enclavijo
airear	aireo
entrepernar	entrepierno
reencauzar	reencauzo
arramblar	arramblo
improbar	impruebo
abemolar	abemolo
desguinzar	desguinzo
aletear	aleteo
descerrajar	descerrajo
restaurar	restauro
retentar	retiento
recetar	receto
alcoholizar	alcoholizo
prospectar	prospecto
campear	campeo
predecir	predigo
alborear	alboreo
replantar	replanto
reinaugurar	reinauguro
herrumbrar	herrumbro
apear	apeo
enunciar	enuncio
estimar	estimo
asquear	asqueo
engullir	engullo
descargar	descargo
asear	aseo
pujar	pujo
teatralizar	teatralizo
envenenar	enveneno
malacostumbrar	malacostumbro
enlosar	enloso
atraillar	atraíllo
sincronizar	sincronizo
latir	lato
chocar	choco
calvar	calvo
arrepentir	arrepiento
desigualar	desigualo
atestiguar	atestiguo
acantilar	acantilo
politizar	politizo
acometer	acometo
desiluminar	desilumino
bruñir	bruño
higienizar	higienizo
platicar	platico
condecorar	condecoro
importar	importo
cohesionar	cohesiono
pesar	peso
fracturar	fracturo
adocenar	adoceno
aromatizar	aromatizo
engangrenar	engangreno
bendecir	bendigo
encomiar	encomio
esponsorizar	esponsorizo
agobiar	agobio
cabrear	cabreo
flamear	flameo
valorizar	valorizo
desbordar	desbordo
desmenuzar	desmenuzo
barruntar	barrunto
usar	uso
ariscar	arisco
bautizar	bautizo
grafitear	grafiteo
sangrar	sangro
traspapelar	traspapelo
mochar	mocho
abalear	abaleo
convidar	convido
generar	genero
gozar	gozo
recurrir	recurro
iluminar	ilumino
empastillar	empastillo
embarullar	embarullo
replegar	repliego
encalmar	encalmo
desilusionar	desilusiono
encarnar	encarno
embalar	embalo
balotar	baloto
adorar	adoro
empoderar	empodero
desatar	desato
amplificar	amplifico
obturar	obturo
concernir	concierno
lisonjear	lisonjeo
desembolsillar	desembolsillo
inocular	inoculo
fidelizar	fidelizo
flexionar	flexiono
visionar	visiono
abundar	abundo
plañir	plaño
desnacionalizar	desnacionalizo
bullir	bullo
impermeabilizar	impermeabilizo
ocupar	ocupo
terminar	termino
romantizar	romantizo
expropiar	expropio
sospechar	sospecho
afiligranar	afiligrano
desobjetivar	desobjetivo
tersar	terso
agitar	agito
cohonder	cohondo
lonchar	loncho
trastocar	trastoco
dignar	digno
deificar	deifico
sobreentender	sobreentiendo
desequilibrar	desequilibro
despeluchar	despelucho
naturalizar	naturalizo
jurar	juro
sorprender	sorprendo
realquilar	realquilo
agregar	agrego
taponear	taponeo
diagramar	diagramo
primar	primo
detestar	detesto
proveer	proveo
vindicar	vindico
tranquilizar	tranquilizo
zombificar	zombifico
especificar	especifico
ortografiar	ortografío
altercar	alterco
reposar	reposo
coletear	coleteo
descompasar	descompaso
astringir	astrinjo
muletear	muleteo
achaparrar	achaparro
envolver	envuelvo
bogar	bogo
contraprogramar	contraprogramo
bascular	basculo
socavar	socavo
engallar	engallo
trozar	trozo
desdentar	desdiento
renacer	renazco
desvanecer	desvanezco
inhumar	inhumo
amoldar	amoldo
candir	cando
altivar	altivo
rasgar	rasgo
desproporcionar	desproporciono
blasfemar	blasfemo
desuscribir	desuscribo
regurgitar	regurgito
aprobar	apruebo
fecundizar	fecundizo
concordar	concuerdo
sondear	sondeo
inmovilizar	inmovilizo
roturar	roturo
sexualizar	sexualizo
desarrebozar	desarrebozo
sobreañadir	sobreañado
berrear	berreo
fletar	fleto
desinhibir	desinhibo
conturbar	conturbo
desacatar	desacato
contornear	contorneo
cuadricular	cuadriculo
reexponer	reexpongo
fluctuar	fluctúo
acicalar	acicalo
matear	mateo
rutilar	rutilo
carrozar	carrozo
abajar	abajo
autonomizar	autonomizo
instaurar	instauro
sobrecalentar	sobrecaliento
orillar	orillo
homologar	homologo
cojear	cojeo
denigrar	denigro
capar	capo
salpimentar	salpimiento
tupir	tupo
sumir	sumo
prometer	prometo
dogmatizar	dogmatizo
lapidar	lapido
enfilar	enfilo
putañear	putañeo
desahijar	desahíjo
nivelar	nivelo
azolvar	azolvo
influenciar	influencio
absolver	absuelvo
teorizar	teorizo
desalinear	desalineo
descarrilar	descarrilo
deteriorar	deterioro
desacelerar	desacelero
franquiciar	franquicio
plantillar	plantillo
bocinar	bocino
acurrucar	acurruco
recomprar	recompro
engrillar	engrillo
acreditar	acredito
estudiar	estudio
alojar	alojo
coactuar	coactúo
reincorporar	reincorporo
elegir	elijo
nutrir	nutro
tullir	tullo
tarar	taro
anexionar	anexiono
divorciar	divorcio
muñir	muño
aparear	apareo
inflar	inflo
torpedear	torpedeo
explayar	explayo
trasegar	trasiego
dilatar	dilato
desempañar	desempaño
exaltar	exalto
reafirmar	reafirmo
enojar	enojo
parear	pareo
aclarar	aclaro
geolocalizar	geolocalizo
fiscalizar	fiscalizo
calcinar	calcino
trinar	trino
miniaturizar	miniaturizo
topetar	topeto
mancar	manco
atiplar	atiplo
acolchonar	acolchono
photoshopear	photoshopeo
estriar	estrío
flexibilizar	flexibilizo
acarear	acareo
rememorar	rememoro
citar	cito
fufar	fufo
acaballar	acaballo
funar	funo
complacer	complazco
apenar	apeno
doler	duelo
coreografiar	coreografío
fragmentar	fragmento
difamar	difamo
sacrificar	sacrifico
recontemplar	recontemplo
desincentivar	desincentivo
alentar	aliento
corear	coreo
ensalzar	ensalzo
customizar	customizo
desenojar	desenojo
desagradar	desagrado
abismar	abismo
escariar	escario
reservar	reservo
desesperanzar	desesperanzo
porfiar	porfío
derrotar	derroto
pelotear	peloteo
alfombrar	alfombro
espontanear	espontaneo
astillar	astillo
poetizar	poetizo
engrasar	engraso
inmigrar	inmigro
sufrir	sufro
lamentar	lamento
mapear	mapeo
nublar	nublo
sobrevivir	sobrevivo
adoptar	adopto
prepintar	prepinto
circunvalar	circunvalo
retapizar	retapizo
cronificar	cronifico
diferir	difiero
avejentar	avejento
atravesar	atravieso
chapuzar	chapuzo
calzar	calzo
redoblar	redoblo
estructurar	estructuro
handicapar	handicapo
cartear	carteo
cerner	cierno
incrustar	incrusto
blanquear	blanqueo
rehabilitar	rehabilito
materializar	materializo
catear	cateo
preconciliar	preconcilio
eyacular	eyaculo
crepitar	crepito
wasapear	wasapeo
vagabundear	vagabundeo
mopear	mopeo
zurriar	zurrío
amarrar	amarro
hilvanar	hilvano
rumiar	rumio
deprecar	depreco
reintroducir	reintroduzco
fotocopiar	fotocopio
menear	meneo
centellar	centello
honorar	honoro
repuntar	repunto
conjurar	conjuro
borrar	borro
enguatar	enguato
anublar	anublo
soportar	soporto
desposeer	desposeo
adquirir	adquiero
desagradecer	desagradezco
codificar	codifico
imprecar	impreco
atalayar	atalayo
pasterizar	pasterizo
despellejar	despellejo
adaguar	adaguo
depurar	depuro
garrapiñar	garrapiño
enguantar	enguanto
retrucar	retruco
osar	oso
fraguar	fraguo
reingresar	reingreso
apaniguar	apaniguo
limpiar	limpio
sonreir	sonrío
cerrar	cierro
escarificar	escarifico
recapacitar	recapacito
tipologizar	tipologizo
desmanar	desmano
traicionar	traiciono
ejecutar	ejecuto
percibir	percibo
chancear	chanceo
estragar	estrago
caramelizar	caramelizo
incursionar	incursiono
desasosegar	desasosiego
tintar	tinto
deglutir	degluto
zapatear	zapateo
dispensar	dispenso
regrabar	regrabo
desparramar	desparramo
perfeccionar	perfecciono
desnucar	desnuco
cizañar	cizaño
pugnar	pugno
atomizar	atomizo
honrar	honro
guardar	guardo
factorizar	factorizo
transmitir	transmito
charolar	charolo
condoler	conduelo
asombrar	asombro
repescar	repesco
maquinar	maquino
custodiar	custodio
sonar	sueno
avecindar	avecindo
lazar	lazo
sumar	sumo
propasar	propaso
aceitar	aceito
transustanciar	transustancio
insolentar	insolento
hipotizar	hipotizo
animar	animo
acalambrar	acalambro
cuantificar	cuantifico
hollar	huello
atrofiar	atrofio
esenciar	esencio
segar	siego
engatusar	engatuso
rebelar	rebelo
arreciar	arrecio
aherrumbrar	aherrumbro
vigorizar	vigorizo
viabilizar	viabilizo
enmudecer	enmudezco
acomplejar	acomplejo
pixelar	pixelo
deshojar	deshojo
autoimpulsar	autoimpulso
batallar	batallo
desenjaezar	desenjaezo
beatificar	beatifico
requerir	requiero
estratificar	estratifico
hidrogenar	hidrogeno
desatrancar	desatranco
lijar	lijo
enrejar	enrejo
versificar	versifico
reestabilizar	reestabilizo
pervivir	pervivo
autorrealizar	autorrealizo
delatar	delato
usurpar	usurpo
reinstaurar	reinstauro
peronizar	peronizo
catalizar	catalizo
entretejer	entretejo
esquiar	esquío
paralelar	paralelo
pormenorizar	pormenorizo
bifurcar	bifurco
reactivar	reactivo
heñir	hiño
chicolear	chicoleo
reventar	reviento
intricar	intrico
comprender	comprendo
entrevistar	entrevisto
introyectar	introyecto
bufar	bufo
particularizar	particularizo
referir	refiero
rebanar	rebano
rebobinar	rebobino
corcovear	corcoveo
detectar	detecto
embellecer	embellezco
peticionar	peticiono
remover	remuevo
readecuar	readecúo
velar	velo
desembocar	desemboco
trepar	trepo
circunnavegar	circunnavego
arbolar	arbolo
pregonar	pregono
matonear	matoneo
entornar	entorno
arribar	arribo
autodestruir	autodestruyo
mencionar	menciono
autorizar	autorizo
sobrealimentar	sobrealimento
escodar	escodo
dañar	daño
apedrear	apedreo
reglar	reglo
desglosar	desgloso
encastrar	encastro
deshebrar	deshebro
encerar	encero
amortajar	amortajo
condecir	condigo
absortar	absorto
deslomar	deslomo
evocar	evoco
proteger	protejo
pespuntar	pespunto
abolir	abolo
loquear	loqueo
bootear	booteo
anualizar	anualizo
embragar	embrago
despezar	despiezo
programar	programo
empujar	empujo
abejonear	abejoneo
trebejar	trebejo
desconcentrar	desconcentro
autoflagelar	autoflagelo
meditar	medito
derrelinquir	derrelinco
conspirar	conspiro
ofrecer	ofrezco
suceder	sucedo
sahumar	sahúmo
mofar	mofo
biografiar	biografío
desturcar	desturco
etiquetar	etiqueto
investigar	investigo
laburar	laburo
desmitificar	desmitifico
infligir	inflijo
semejar	semejo
trastabillar	trastabillo
aconsejar	aconsejo
afrentar	afrento
rielar	rielo
gratar	grato
colear	coleo
fabricar	fabrico
mentalizar	mentalizo
prevaricar	prevarico
relucir	reluzco
oficiar	oficio
marginalizar	marginalizo
afiebrar	afiebro
gasificar	gasifico
retoñar	retoño
opinar	opino
bastardear	bastardeo
culebrear	culebreo
promesar	promeso
calcular	calculo
interrogar	interrogo
chismorrear	chismorreo
insultar	insulto
haraganear	haraganeo
litigar	litigo
acostumbrar	acostumbro
dimensionar	dimensiono
envergar	envergo
criminalizar	criminalizo
amueblar	amueblo
atizar	atizo
involucionar	involuciono
reagrupar	reagrupo
rectar	recto
sarmentar	sarmiento
ponchar	poncho
castañetear	castañeteo
ranciar	rancio
desbarrar	desbarro
motivar	motivo
mechar	mecho
encriptar	encripto
prohijar	prohíjo
entortar	entorto
autoexplorar	autoexploro
escombrar	escombro
granizar	granizo
coger	cojo
atorar	atoro
disolver	disuelvo
enrumbar	enrumbo
pegar	pego
erizar	erizo
trasportar	trasporto
exceptuar	exceptúo
aprisionar	aprisiono
embaldosar	embaldoso
estipular	estipulo
maleficiar	maleficio
enganchar	engancho
cortejar	cortejo
zambullir	zambullo
desensibilizar	desensibilizo
metalizar	metalizo
ensalivar	ensalivo
abrogar	abrogo
bombear	bombeo
regionalizar	regionalizo
kilometrar	kilometro
destartalar	destartalo
electrificar	electrifico
incitar	incito
relajar	relajo
chinar	chino
rebatar	rebato
profesar	profeso
desguanguañar	desguanguaño
federalizar	federalizo
polinizar	polinizo
ensangrentar	ensangriento
razonar	razono
malvar	malvo
apolillar	apolillo
ampliar	amplío
respectar	respecto
izar	izo
masacrar	masacro
otear	oteo
adiar	adío
ajardinar	ajardino
pedalear	pedaleo
desmarimbar	desmarimbo
lactar	lacto
garantizar	garantizo
precocinar	precocino
presagiar	presagio
empavesar	empaveso
vendar	vendo
triunfar	triunfo
equivocar	equivoco
matar	mato
suspender	suspendo
descarnar	descarno
emular	emulo
cucar	cuco
achicar	achico
listar	listo
cafichar	caficho
refregar	refriego
consolar	consuelo
escindir	escindo
escoger	escojo
escolarizar	escolarizo
burocratizar	burocratizo
aunar	aúno
amadrinar	amadrino
tamizar	tamizo
delaminar	delamino
vapulear	vapuleo
canturrear	canturreo
trapear	trapeo
mascar	masco
desencapotar	desencapoto
endiosar	endioso
barrer	barro
plegar	pliego
ataviar	atavio
dilucidar	dilucido
segregar	segrego
arropar	arropo
tributar	tributo
decelerar	decelero
pizcar	pizco
resecar	reseco
atronar	atrueno
desamarrar	desamarro
desestimar	desestimo
desemplear	desempleo
academizar	academizo
avasallar	avasallo
preconizar	preconizo
desarmar	desarmo
refaccionar	refacciono
escarmentar	escarmiento
recular	reculo
desprejuiciar	desprejuicio
hincar	hinco
fundir	fundo
escrutar	escruto
escampar	escampo
desarrugar	desarrugo
retratar	retrato
ensordecer	ensordezco
contradecir	contradigo
imputar	imputo
tirotear	tiroteo
englobar	englobo
competer	competo
perturbar	perturbo
remangar	remango
nausear	nauseo
enardecer	enardezco
externalizar	externalizo
cliquear	cliqueo
arrastrar	arrastro
apreciar	aprecio
escarchar	escarcho
colaborar	colaboro
arquear	arqueo
sistematizar	sistematizo
desfigurar	desfiguro
indicar	indico
personificar	personifico
suputar	suputo
espumarajear	espumarajeo
vitalizar	vitalizo
espumear	espumeo
institucionalizar	institucionalizo
jibarizar	jibarizo
nuclearizar	nuclearizo
despercudir	despercudo
sedimentar	sedimento
prorrogar	prorrogo
optar	opto
espitar	espito
encuerar	encuero
subsumir	subsumo
retorcer	retuerzo
desadornar	desadorno
celebrar	celebro
ausentar	ausento
aburrir	aburro
exportar	exporto
entablillar	entablillo
ambientar	ambiento
minusvalorar	minusvaloro
bronquear	bronqueo
ondear	ondeo
antagonizar	antagonizo
subvencionar	subvenciono
malograr	malogro
predefinir	predefino
inculpar	inculpo
espesar	espeso
pleitear	pleiteo
tapear	tapeo
adobar	adobo
entroncar	entronco
desrabar	desrabo
aifonear	aifoneo
federar	federo
curar	curo
anteceder	antecedo
adueñar	adueño
encrestar	encresto
sesionar	sesiono
embestir	embisto
dialogar	dialogo
alancear	alanceo
envasar	envaso
abortar	aborto
representar	represento
juguetear	jugueteo
desminar	desmino
aterrar	atierro
clausular	clausulo
apoyar	apoyo
sobrellenar	sobrelleno
embelesar	embeleso
embotar	emboto
averiar	averío
independizar	independizo
barrar	barro
pastar	pasto
entumecer	entumezco
entrecruzar	entrecruzo
degustar	degusto
licenciar	licencio
rebrincar	rebrinco
desacoplar	desacoplo
sopar	sopo
desguarnecer	desguarnezco
chatear	chateo
demorar	demoro
placer	plazco
balar	balo
estrechar	estrecho
pretermitir	pretermito
ensañar	ensaño
fecundar	fecundo
asustar	asusto
deber	debo
sopear	sopeo
enrollar	enrollo
cloroformizar	cloroformizo
empeorar	empeoro
rifar	rifo
laquear	laqueo
liberalizar	liberalizo
cejar	cejo
resaltar	resalto
galardonar	galardono
llagar	llago
desnacer	desnazco
esputar	esputo
satanizar	satanizo
abisagrar	abisagro
remplazar	remplazo
autojustificar	autojustifico
acaramelar	acaramelo
levitar	levito
posar	poso
desmoronar	desmorono
enhornar	enhorno
olvidar	olvido
exclamar	exclamo
subarrendar	subarriendo
desactivar	desactivo
desautorizar	desautorizo
execrar	execro
mediatizar	mediatizo
tumultuar	tumultúo
llevar	llevo
sujetar	sujeto
atirantar	atiranto
aniñar	aniño
impender	impendo
reorientar	reoriento
ayustar	ayusto
mortificar	mortifico
acensar	acenso
encadenar	encadeno
trasvestir	trasvisto
palpar	palpo
malbaratar	malbarato
beneficiar	beneficio
descohesionar	descohesiono
ovacionar	ovaciono
enviudar	enviudo
acelerar	acelero
malvender	malvendo
incinerar	incinero
remunerar	remunero
encuadernar	encuaderno
sobornar	soborno
legitimar	legitimo
tararear	tarareo
deslegañar	deslegaño
atisbar	atisbo
aupar	aúpo
bolear	boleo
macizar	macizo
revivir	revivo
deslavar	deslavo
desmelenar	desmeleno
bonificar	bonifico
destemplar	destemplo
displacer	displazco
untar	unto
desinstalar	desinstalo
desprecintar	desprecinto
mezquinar	mezquino
despenar	despeno
reparar	reparo
presionar	presiono
anunciar	anuncio
clarear	clareo
trasgredir	trasgredo
distender	distiendo
abrir	abro
ahincar	ahínco
remendar	remiendo
copar	copo
imbricar	imbrico
modelar	modelo
hablar	hablo
cubrir	cubro
mangar	mango
embalsamar	embalsamo
sobrerreaccionar	sobrerreacciono
durar	duro
prolongar	prolongo
aniquilar	aniquilo
zanganear	zanganeo
descabezar	descabezo
presentar	presento
hervir	hiervo
autoperfeccionar	autoperfecciono
anclar	anclo
martirizar	martirizo
desafinar	desafino
descontextualizar	descontextualizo
emputecer	emputezco
endulzar	endulzo
justificar	justifico
ratear	rateo
apersonar	apersono
desgraciar	desgracio
descolorir	descoloro
despenalizar	despenalizo
pirrar	pirro
vigiar	vigío
ensebar	ensebo
desvincular	desvinculo
escasear	escaseo
acumular	acumulo
enrojecer	enrojezco
arbitrar	arbitro
ampollar	ampollo
sobrepagar	sobrepago
alijar	alijo
cepillar	cepillo
maquillar	maquillo
vivaquear	vivaqueo
vitrificar	vitrifico
adeudar	adeudo
esperanzar	esperanzo
alzar	alzo
preconcebir	preconcibo
chacharear	chachareo
implantar	implanto
garbar	garbo
lanchar	lancho
apañar	apaño
discursar	discurso
metastatizar	metastatizo
malmeter	malmeto
romancear	romanceo
capilar	capilo
repatriar	repatrío
controlar	controlo
telonear	teloneo
xerografiar	xerografío
levar	levo
acotolar	acotolo
apoderar	apodero
trocear	troceo
financiar	financio
enajenar	enajeno
morar	moro
palmotear	palmoteo
meteorizar	meteorizo
minar	mino
ramificar	ramifico
boletear	boleteo
descumplir	descumplo
aullar	aúllo
jimar	jimo
encuclillar	encuclillo
calabriar	calabrio
tentar	tiento
rentabilizar	rentabilizo
readquirir	readquiro
revolcar	revuelco
compadrar	compadro
feriar	ferio
azulejar	azulejo
glosar	gloso
novelar	novelo
cribar	cribo
depilar	depilo
amarillear	amarilleo
atorgar	atorgo
disfrutar	disfruto
apretujar	apretujo
pelechar	pelecho
mimir	mimo
amañanar	amañano
adsorber	adsorbo
quedar	quedo
circunferir	circunfiero
embarnecer	embarnezco
solver	suelvo
contabilizar	contabilizo
apresurar	apresuro
prendar	prendo
regentear	regenteo
retrepar	retrepo
desempedrar	desempiedro
saltear	salteo
ruborizar	ruborizo
sobrevolar	sobrevuelo
humedecer	humedezco
objetivar	objetivo
despersonalizar	despersonalizo
serruchar	serrucho
relocalizar	relocalizo
intensar	intenso
avalar	avalo
espatarrar	espatarro
festejar	festejo
orinar	orino
confraternizar	confraternizo
momificar	momifico
renombrar	renombro
instilar	instilo
apresar	apreso
empolvar	empolvo
retroceder	retrocedo
densificar	densifico
volcar	vuelco
aplicar	aplico
bombardear	bombardeo
encasillar	encasillo
consternar	consterno
embarazar	embarazo
cercenar	cerceno
escanear	escaneo
sofisticar	sofistico
reactualizar	reactualizo
trasuntar	trasunto
alunizar	alunizo
buzar	buzo
comediar	comedio
adormilar	adormilo
descubrir	descubro
escudriñar	escudriño
inhibir	inhibo
leñar	leño
electrizar	electrizo
presidir	presido
aplastar	aplasto
solventar	solvento
cacarear	cacareo
acongojar	acongojo
comadrear	comadreo
apalear	apaleo
lucir	luzco
monologar	monologo
ceder	cedo
borronear	borroneo
apetecer	apetezco
complicar	complico
censar	censo
iludir	iludo
democratizar	democratizo
petear	peteo
reestablecer	reestablezco
brincar	brinco
maltear	malteo
mermar	mermo
aruñar	aruño
desinteresar	desintereso
recordar	recuerdo
readmitir	readmito
excitar	excito
amalgamar	amalgamo
excomulgar	excomulgo
pulir	pulo
arenar	areno
amenizar	amenizo
traumatizar	traumatizo
engañar	engaño
apiadar	apiado
trasmutar	trasmuto
escrudriñar	escrudriño
medicar	medico
cazar	cazo
atarantar	ataranto
faenar	faeno
cuadruplicar	cuadruplico
aventurar	aventuro
melear	meleo
testar	testo
adjuntar	adjunto
acariñar	acariño
angostar	angosto
supercomprimir	supercomprimo
contextualizar	contextualizo
humanizar	humanizo
adiestrar	adiestro
tabular	tabulo
inactivar	inactivo
maniobrar	maniobro
paliar	palio
masar	maso
proceder	procedo
envarar	envaro
entregar	entrego
transcurrir	transcurro
agilizar	agilizo
focalizar	focalizo
colectar	colecto
inmatricular	inmatriculo
estornudar	estornudo
almidonar	almidono
mestizar	mestizo
chingar	chingo
mangonear	mangoneo
apocopar	apocopo
encestar	encesto
descoser	descoso
despuntar	despunto
fanfarronear	fanfarroneo
subsidiar	subsidio
titubear	titubeo
desencasquillar	desencasquillo
despilfarrar	despilfarro
bardar	bardo
asemejar	asemejo
pergeñar	pergeño
lengüetear	lengüeteo
rendir	rindo
hormigonar	hormigono
reversar	reverso
socorrer	socorro
apocar	apoco
conocer	conozco
compungir	compunjo
besuquear	besuqueo
escalonar	escalono
cuadrar	cuadro
verter	vierto
trillar	trillo
alegar	alego
crecer	crezco
internar	interno
sociologizar	sociologizo
jaspear	jaspeo
laurear	laureo
labrar	labro
anisar	aniso
estacionar	estaciono
rescatar	rescato
purgar	purgo
destazar	destazo
trajear	trajeo
desainar	desaíno
desfalcar	desfalco
trastornar	trastorno
disturbar	disturbo
infusionar	infusiono
ribetear	ribeteo
madrear	madreo
mancillar	mancillo
concientizar	concientizo
atentar	atento
alebrestar	alebresto
acojonar	acojono
enconar	encono
entusiasmar	entusiasmo
cavar	cavo
toser	toso
desanimar	desanimo
resonar	resueno
encastillar	encastillo
volver	vuelvo
chirriar	chirrío
acatar	acato
anarquizar	anarquizo
singularizar	singularizo
maleducar	maleduco
embetunar	embetuno
arponear	arponeo
litar	lito
contrariar	contrarío
noquear	noqueo
vidriar	vidrio
machetear	macheteo
emparentar	empariento
desbarajustar	desbarajusto
hostilizar	hostilizo
baldosar	baldoso
racionar	raciono
dentellear	dentelleo
raspar	raspo
aneblar	anieblo
aguadar	aguado
abanderizar	abanderizo
secretar	secreto
aguardar	aguardo
inmergir	inmerjo
dotar	doto
fachar	facho
cautivar	cautivo
espachurrar	espachurro
perorar	peroro
arrostrar	arrostro
asestar	asesto
lisiar	lisio
plantear	planteo
engatillar	engatillo
destorcer	destuerzo
españolear	españoleo
relativizar	relativizo
desaprender	desaprendo
agradecer	agradezco
ahitar	ahíto
enjuiciar	enjuicio
aflautar	aflauto
arrear	arreo
ignorar	ignoro
aventar	aviento
explotar	exploto
padecer	padezco
desfogar	desfogo
malhumorar	malhumoro
desembarcar	desembarco
rabiar	rabio
aterciopelar	aterciopelo
convocar	convoco
edificar	edifico
nombrar	nombro
engarabitar	engarabito
represaliar	represalio
sobredimensionar	sobredimensiono
transvasar	transvaso
dormir	duermo
flautear	flauteo
cuartear	cuarteo
ventar	viento
rastrear	rastreo
despegar	despego
aliviar	alivio
asitir	asito
plagiar	plagio
patrullar	patrullo
retransmitir	retransmito
ripostar	riposto
apodar	apodo
reiniciar	reinicio
propulsar	propulso
transferir	transfiero
incomodar	incomodo
desgranar	desgrano
peligrar	peligro
desproteger	desprotejo
cabecear	cabeceo
repletar	repleto
secar	seco
deportar	deporto
escaramuzar	escaramuzo
apartar	aparto
provocar	provoco
ungir	unjo
ajustar	ajusto
parecer	parezco
montar	monto
anonimizar	anonimizo
desgajar	desgajo
contrabandear	contrabandeo
amordazar	amordazo
ripiar	ripio
frivolizar	frivolizo
aspar	aspo
ensoñar	ensueño
decrecer	decrezco
cecinar	cecino
desnudar	desnudo
intitular	intitulo
sedar	sedo
dictaminar	dictamino
afrijolar	afrijolo
caldear	caldeo
preestablecer	preestablezco
desembuchar	desembucho
herrar	hierro
combatir	combato
desenjalmar	desenjalmo
canicular	caniculo
requisar	requiso
repeler	repelo
pulsear	pulseo
memorizar	memorizo
parcelar	parcelo
galopar	galopo
moralizar	moralizo
truncar	trunco
diagonalizar	diagonalizo
triangular	triangulo
hacer	hago
reaccionar	reacciono
especiar	especio
plagar	plago
contristar	contristo
filosofar	filosofo
piar	pío
pretextar	pretexto
contemplar	contemplo
rutar	ruto
alaciar	alacio
consensuar	consensúo
confiscar	confisco
polimerizar	polimerizo
fagocitar	fagocito
percudir	percudo
arriar	arrío
especializar	especializo
redargüir	redarguyo
prefinanciar	prefinancio
barrenar	barreno
vulcanizar	vulcanizo
cablegrafiar	cablegrafío
constar	consto
vacilar	vacilo
adecuar	adecúo
jeringar	jeringo
gayar	gayo
depravar	depravo
condonar	condono
roncar	ronco
robotizar	robotizo
abdicar	abdico
acuantiar	acuantío
reglamentar	reglamento
repeinar	repeino
resoplar	resoplo
promover	promuevo
exhumar	exhumo
oxigenar	oxigeno
optimar	optimo
subcontratar	subcontrato
agendar	agendo
charlatanear	charlataneo
menar	meno
lechar	lecho
convulsionar	convulsiono
depositar	deposito
prescribir	prescribo
enfrascar	enfrasco
penalizar	penalizo
comprometer	comprometo
oler	huelo
pasmar	pasmo
invocar	invoco
anihilar	anihilo
patear	pateo
españolizar	españolizo
camuflar	camuflo
aletargar	aletargo
defeccionar	defecciono
zaherir	zahiero
encerrar	encierro
divulgar	divulgo
manipular	manipulo
transigir	transijo
destrabar	destrabo
tildar	tildo
amover	amuevo
discrepar	discrepo
desaliñar	desaliño
contundir	contundo
atezar	atezo
atesorar	atesoro
encorvar	encorvo
garrapatear	garrapateo
borbotear	borboteo
cintilar	cintilo
residir	resido
reconsiderar	reconsidero
morrear	morreo
escocer	escuezo
despachar	despacho
desatascar	desatasco
proferir	profiero
bañar	baño
subrayar	subrayo
reinsertar	reinserto
curvar	curvo
permeabilizar	permeabilizo
rebañar	rebaño
ahumar	ahúmo
bachillerar	bachillero
pronosticar	pronostico
situar	sitúo
rehilar	rehílo
mineralizar	mineralizo
concretar	concreto
recalcar	recalco
soldar	sueldo
amamantar	amamanto
acoplar	acoplo
desbravar	desbravo
asonar	asueno
reciclar	reciclo
envergonzar	envergüenzo
chequear	chequeo
chapucear	chapuceo
embarrar	embarro
carcajear	carcajeo
soliviantar	solivianto
pochear	pocheo
paralizar	paralizo
sonorizar	sonorizo
apremiar	apremio
profanar	profano
abejear	abejeo
viciar	vicio
confiar	confío
abatatar	abatato
espaldar	espaldo
bastonear	bastoneo
raptar	rapto
reconfigurar	reconfiguro
reciprocar	reciproco
detentar	detento
desmalezar	desmalezo
cuestionar	cuestiono
desmaquillar	desmaquillo
taponar	tapono
sustantivar	sustantivo
relevar	relevo
obnubilar	obnubilo
retinar	retino
entubar	entubo
desmarcar	desmarco
conjuntar	conjunto
temperar	tempero
emplomar	emplomo
adivinar	adivino
enrarecer	enrarezco
demacrar	demacro
pajaronear	pajaroneo
anodizar	anodizo
concurrir	concurro
incrementar	incremento
amojonar	amojono
desparejar	desparejo
chavar	chavo
tranzar	tranzo
esterilizar	esterilizo
impersonalizar	impersonalizo
pilotear	piloteo
techar	techo
africanizar	africanizo
desestabilizar	desestabilizo
rehallar	rehallo
orquestar	orquesto
desconectar	desconecto
postular	postulo
finalizar	finalizo
persignar	persigno
capitular	capitulo
cerciorar	cercioro
enjutar	enjuto
triscar	trisco
dividir	divido
apiñar	apiño
descocer	descuezo
adicionar	adiciono
pochar	pocho
reteñir	retiño
visibilizar	visibilizo
enhebrar	enhebro
transmutar	transmuto
coagular	coagulo
aficionar	aficiono
callejear	callejeo
banalizar	banalizo
frasear	fraseo
galantear	galanteo
clarificar	clarifico
vilipendiar	vilipendio
rallar	rallo
susurrar	susurro
banderillear	banderilleo
cartelizar	cartelizo
accesar	acceso
simpatizar	simpatizo
antedecir	antedigo
desvencijar	desvencijo
cespitar	cespito
filar	filo
tapiar	tapio
estatificar	estatifico
encaminar	encamino
trashumar	trashumo
tonsurar	tonsuro
pescar	pesco
dietar	dieto
camotear	camoteo
palmar	palmo
asuntar	asunto
ufanar	ufano
parquear	parqueo
climatizar	climatizo
desacordar	desacuerdo
encarnizar	encarnizo
desgreñar	desgreño
sesgar	sesgo
agotar	agoto
amnistiar	amnistío
arrendar	arriendo
estacar	estaco
escalofriar	escalofrío
batear	bateo
disipar	disipo
alunar	aluno
ayudar	ayudo
entramar	entramo
islamizar	islamizo
interceptar	intercepto
atarear	atareo
amargar	amargo
bregar	brego
cunar	cuno
disfamar	disfamo
criminar	crimino
maltratar	maltrato
descascarillar	descascarillo
uncir	unzo
conformar	conformo
desolar	desuelo
descruzar	descruzo
descompensar	descompenso
anticipar	anticipo
vengar	vengo
torturar	torturo
centrifugar	centrifugo
unificar	unifico
decomisar	decomiso
taquigrafiar	taquigrafío
alisar	aliso
desertificar	desertifico
desovar	desovo
recifrar	recifro
intensificar	intensifico
infartar	infarto
taladrar	taladro
retipificar	retipifico
excarcelar	excarcelo
tasar	taso
amonestar	amonesto
abogar	abogo
predeterminar	predetermino
editar	edito
indulgenciar	indulgencio
activar	activo
elucubrar	elucubro
emplumar	emplumo
gatear	gateo
explorar	exploro
malparir	malparo
reconcomer	reconcomo
evaluar	evalúo
censurar	censuro
ingerir	ingiero
trasfigurar	trasfiguro
afilar	afilo
jadear	jadeo
diseñar	diseño
esculpir	esculpo
manar	mano
metar	meto
recostar	recuesto
recochinear	recochineo
pacificar	pacifico
enredar	enredo
intubar	intubo
axiomatizar	axiomatizo
oir	oigo
domar	domo
trolear	troleo
ficcionar	ficciono
desabotonar	desabotono
romper	rompo
apaciguar	apaciguo
autosatisfacer	autosatisfago
ensanchar	ensancho
redondear	redondeo
encabezar	encabezo
enmarcar	enmarco
desencaminar	desencamino
ciar	cío
burilar	burilo
ensartar	ensarto
compulsar	compulso
proliferar	prolifero
argumentar	argumento
filtrar	filtro
ruralizar	ruralizo
toldar	toldo
intermediar	intermedio
sepultar	sepulto
advertir	advierto
jaquir	jaco
simbolizar	simbolizo
eclosionar	eclosiono
idealizar	idealizo
bofetear	bofeteo
pordiosear	pordioseo
achacar	achaco
explicar	explico
desencriptar	desencripto
espulgar	espulgo
descorrer	descorro
desangrar	desangro
invertir	invierto
repintar	repinto
bloquear	bloqueo
jaranear	jaraneo
occidentalizar	occidentalizo
abotonar	abotono
antepasar	antepaso
permear	permeo
golfear	golfeo
laminar	lamino
sancochar	sancocho
desenroscar	desenrosco
revitalizar	revitalizo
inhalar	inhalo
travesar	travieso
fantasear	fantaseo
chivar	chivo
reconquistar	reconquisto
acobardar	acobardo
gorgotear	gorgoteo
amostazar	amostazo
inferir	infiero
urdir	urdo
rebrotar	rebroto
arrebujar	arrebujo
acepillar	acepillo
desquiciar	desquicio
connotar	connoto
rizar	rizo
satisfacer	satisfago
encurtir	encurto
embebecer	embebezco
entronizar	entronizo
encimar	encimo
cañar	caño
confabular	confabulo
putear	puteo
escamotear	escamoteo
rebalsar	rebalso
debatir	debato
suplantar	suplanto
validar	valido
conquistar	conquisto
impresionar	impresiono
incorporar	incorporo
devorar	devoro
reflexionar	reflexiono
descondicionar	descondiciono
acuitar	acuito
desmontar	desmonto
solidarizar	solidarizo
desempatar	desempato
carbonar	carbono
ahorcar	ahorco
confortar	conforto
satirizar	satirizo
precarizar	precarizo
espantar	espanto
reclasificar	reclasifico
arrancar	arranco
anodinar	anodino
decapitar	decapito
modernizar	modernizo
carraspear	carraspeo
afortunar	afortuno
aterrizar	aterrizo
reurbanizar	reurbanizo
almibarar	almibaro
rastrillar	rastrillo
polir	polo
informar	informo
resollar	resuello
lujuriar	lujurio
disimular	disimulo
desaguar	desaguo
espolvorear	espolvoreo
arranchar	arrancho
acidular	acidulo
enjambrar	enjambro
lacrar	lacro
acalorar	acaloro
ralear	raleo
descifrar	descifro
vencer	venzo
dorar	doro
pauperizar	pauperizo
remolcar	remolco
ornamentar	ornamento
reencantar	reencanto
rular	rulo
loar	loo
asesorar	asesoro
volear	voleo
lentificar	lentifico
twittear	twitteo
destapar	destapo
musitar	musito
residenciar	residencio
preelaborar	preelaboro
refundar	refundo
angarillar	angarillo
destetar	desteto
payasear	payaseo
normar	normo
subvertir	subvierto
aderezar	aderezo
diferenciar	diferencio
educar	educo
enronchar	enroncho
rezagar	rezago
estropear	estropeo
majar	majo
mamilar	mamilo
entrenar	entreno
otorgar	otorgo
apasionar	apasiono
desalinizar	desalinizo
contraatacar	contraataco
desencajar	desencajo
afear	afeo
albergar	albergo
prefabricar	prefabrico
centonar	centono
encarcelar	encarcelo
desacralizar	desacralizo
gorjear	gorjeo
almendrar	almendro
cancelar	cancelo
espadar	espado
impedir	impido
mazar	mazo
comer	como
acondicionar	acondiciono
solfear	solfeo
enjaretar	enjareto
inmutar	inmuto
protagonizar	protagonizo
suicidar	suicido
defenestrar	defenestro
legar	lego
divinar	divino
pirar	piro
industriar	industrio
narcotizar	narcotizo
alcanzar	alcanzo
versionar	versiono
resfriar	resfrío
descarar	descaro
debutar	debuto
aventajar	aventajo
enlozar	enlozo
esquilmar	esquilmo
cimentar	cimiento
excoriar	excorio
redireccionar	redirecciono
puntar	punto
litografiar	litografío
afrancesar	afranceso
refrenar	refreno
retundir	retundo
forrar	forro
gimotear	gimoteo
cairelar	cairelo
zigzaguear	zigzagueo
brisar	briso
repotenciar	repotencio
fotografiar	fotografío
revistar	revisto
renovar	renuevo
fisgar	fisgo
arrasar	arraso
carnear	carneo
desollar	desuello
orientar	oriento
entrecerrar	entrecierro
recuperar	recupero
reanimar	reanimo
embocar	emboco
trufar	trufo
constipar	constipo
copetear	copeteo
radiar	radio
reprender	reprendo
sindicar	sindico
enfrentar	enfrento
zabordar	zabordo
lagrimear	lagrimeo
reabrir	reabro
apagar	apago
deslustrar	deslustro
colapsar	colapso
chanchar	chancho
centralizar	centralizo
figurar	figuro
agolpar	agolpo
desenfadar	desenfado
revolotear	revoloteo
fructificar	fructifico
someter	someto
donar	dono
cimar	cimo
propugnar	propugno
jalonear	jaloneo
plomar	plomo
desclasificar	desclasifico
ociar	ocio
tipificar	tipifico
sobreestimar	sobreestimo
hurgar	hurgo
almacenar	almaceno
graznar	grazno
cocer	cuezo
disentir	disiento
establecer	establezco
encocorar	encocoro
chupar	chupo
revender	revendo
estarcir	estarzo
tropicalizar	tropicalizo
gradar	grado
acceder	accedo
oralizar	oralizo
exiliar	exilio
reportear	reporteo
dulzurar	dulzuro
concitar	concito
prestar	presto
reunificar	reunifico
descortezar	descortezo
pitar	pito
embrollar	embrollo
inspeccionar	inspecciono
reprochar	reprocho
cimbrar	cimbro
latiguear	latigueo
alfilerar	alfilero
desemejar	desemejo
chillar	chillo
esplender	esplendo
derrumbar	derrumbo
trompezar	trompiezo
desperdiciar	desperdicio
comprimir	comprimo
regobernar	regobierno
moler	muelo
lograr	logro
precalentar	precaliento
imaginar	imagino
encabritar	encabrito
ultracentrifugar	ultracentrifugo
resguardar	resguardo
pastorear	pastoreo
desnivelar	desnivelo
desmedrar	desmedro
maizar	maizo
tricotar	tricoto
desperdigar	desperdigo
regar	riego
americanizar	americanizo
autodefinir	autodefino
codiciar	codicio
requemar	requemo
arañar	araño
catalogar	catalogo
sobrestimar	sobrestimo
tuitear	tuiteo
clorinar	clorino
comentar	comento
comparecer	comparezco
replicar	replico
expulsar	expulso
impetrar	impetro
desanudar	desanudo
estelarizar	estelarizo
predominar	predomino
aforrar	aforro
azufrar	azufro
declarar	declaro
arreglar	arreglo
rechazar	rechazo
disecar	diseco
monitorizar	monitorizo
minimalizar	minimalizo
redescubrir	redescubro
encanecer	encanezco
categorizar	categorizo
barbarizar	barbarizo
entallar	entallo
recrecer	recrezco
abusar	abuso
embobecer	embobezco
alambicar	alambico
expeler	expelo
interrelacionar	interrelaciono
abofetear	abofeteo
sutilizar	sutilizo
traquear	traqueo
ayuntar	ayunto
familiarizar	familiarizo
hostiar	hostío
ronchar	roncho
vaciar	vacío
conciliar	concilio
perpetuar	perpetúo
individualizar	individualizo
zapar	zapo
gloriar	glorío
ansiar	ansío
halagar	halago
enmugrar	enmugro
sobreexplotar	sobreexploto
flojear	flojeo
obstaculizar	obstaculizo
resemblar	resemblo
cernir	cierno
sanjar	sanjo
abrigar	abrigo
describir	describo
disparar	disparo
desabejar	desabejo
fustigar	fustigo
amantar	amanto
achispar	achispo
insubordinar	insubordino
titularizar	titularizo
absorber	absorbo
retuitear	retuiteo
ningunear	ninguneo
prepagar	prepago
vivir	vivo
escupir	escupo
reptar	repto
postrar	postro
exteriorizar	exteriorizo
atenuar	atenúo
chapurrear	chapurreo
ameritar	amerito
invalidar	invalido
propagar	propago
centellear	centelleo
impeler	impelo
enrevesar	enreveso
enrabietar	enrabieto
entremezclar	entremezclo
desmayar	desmayo
tornear	torneo
friccionar	fricciono
resarcir	resarzo
conjeturar	conjeturo
acuartelar	acuartelo
repulsar	repulso
asumir	asumo
licuar	licúo
emperezar	emperezo
ensuciar	ensucio
desistir	desisto
impostar	imposto
corchar	corcho
desencolar	desencolo
combinar	combino
coronar	corono
desrizar	desrizo
masajear	masajeo
gravar	gravo
anestesiar	anestesio
prefijar	prefijo
incordiar	incordio
jaquear	jaqueo
estañar	estaño
atildar	atildo
urbanizar	urbanizo
transparentar	transparento
exentar	exento
destajar	destajo
recomenzar	recomienzo
uniformar	uniformo
sanar	sano
cuajar	cuajo
bracear	braceo
robar	robo
apelotonar	apelotono
desorejar	desorejo
cabriolar	cabriolo
encaperuzar	encaperuzo
criopreservar	criopreservo
chufar	chufo
amansar	amanso
rodar	ruedo
supervivir	supervivo
verdecer	verdezco
divagar	divago
acachetear	acacheteo
parchar	parcho
desteñir	destiño
incensar	incienso
desapasionar	desapasiono
ulular	ululo
broncear	bronceo
reinvertir	reinvierto
adulterar	adultero
enlistar	enlisto
presidiar	presidio
cortocircuitar	cortocircuito
desorbitar	desorbito
reiterar	reitero
ciclar	ciclo
muestrear	muestreo
parlar	parlo
aserrar	asierro
manchar	mancho
azarar	azaro
empalar	empalo
personalizar	personalizo
sopesar	sopeso
depredar	depredo
naufragar	naufrago
mezclar	mezclo
latinar	latino
circuncidar	circuncido
contusionar	contusiono
amar	amo
abombar	abombo
travestir	travesto
conseguir	consigo
multar	multo
desembarazar	desembarazo
cotorrear	cotorreo
pulular	pululo
vedar	vedo
restallar	restallo
autoincluir	autoincluyo
mantear	manteo
rasurar	rasuro
objetar	objeto
educir	eduzco
fosforilar	fosforilo
mondar	mondo
enrielar	enrielo
insidiar	insidio
prestigiar	prestigio
embalsar	embalso
desacostumbrar	desacostumbro
desenterrar	desentierro
intimidar	intimido
tolerar	tolero
amputar	amputo
seleccionar	selecciono
puntuar	puntúo
fosforecer	fosforezco
subastar	subasto
octavar	octavo
anadear	anadeo
botanizar	botanizo
exhibir	exhibo
añejar	añejo
permanecer	permanezco
secundar	secundo
adornar	adorno
apegar	apego
hojear	hojeo
impugnar	impugno
olisquear	olisqueo
escudillar	escudillo
acorralar	acorralo
serviciar	servicio
rehogar	rehogo
reinscribir	reinscribo
campar	campo
desesperar	desespero
esconder	escondo
desembotar	desemboto
enlentecer	enlentezco
alquitranar	alquitrano
ronronear	ronroneo
reacoplar	reacoplo
trocar	trueco
repantigar	repantigo
disfrazar	disfrazo
sudar	sudo
positivizar	positivizo
expedir	expido
vomitar	vomito
erradicar	erradico
adular	adulo
aturullar	aturullo
petar	peto
interesar	intereso
rebajar	rebajo
acuchillar	acuchillo
transbordar	transbordo
reformular	reformulo
desayunar	desayuno
volar	vuelo
ridiculizar	ridiculizo
interiorizar	interiorizo
derrapar	derrapo
cesar	ceso
llorar	lloro
descaderar	descadero
arremeter	arremeto
retar	reto
cursar	curso
mecer	mezo
prenegociar	prenegocio
jinetear	jineteo
confligir	conflijo
teletransportar	teletransporto
cuchichear	cuchicheo
desbocar	desboco
consentir	consiento
malignar	maligno
chulear	chuleo
acallar	acallo
exagerar	exagero
reexaminar	reexamino
tonificar	tonifico
emperrar	emperro
rejuvenecer	rejuvenezco
desparasitar	desparasito
controvertir	controvierto
ejercitar	ejercito
retumbar	retumbo
esgrimir	esgrimo
acicular	aciculo
rancar	ranco
agachar	agacho
pensionar	pensiono
reaparecer	reaparezco
atufar	atufo
enranciar	enrancio
comulgar	comulgo
constreñir	constriño
enrutar	enruto
cortar	corto
envejecer	envejezco
castizar	castizo
sortear	sorteo
ahuecar	ahueco
colindar	colindo
vituperar	vitupero
formatear	formateo
costear	costeo
abollar	abollo
cachear	cacheo
anonadar	anonado
deducir	deduzco
apuntalar	apuntalo
sobreseer	sobreseo
atañer	ataño
ordenar	ordeno
aguijonear	aguijoneo
costurar	costuro
desairar	desairo
surgir	surjo
arramplar	arramplo
elogiar	elogio
descolocar	descoloco
asechar	asecho
instalar	instalo
denostar	denuesto
amañar	amaño
estribar	estribo
punzar	punzo
acopiar	acopio
inhabilitar	inhabilito
ahogar	ahogo
definir	defino
entrometer	entrometo
descerebrar	descerebro
ubicar	ubico
desnutrir	desnutro
venenciar	venencio
despejar	despejo
desmochar	desmocho
manosear	manoseo
reducir	reduzco
desencarnar	desencarno
fallecer	fallezco
desestructurar	desestructuro
transplantar	transplanto
ablandar	ablando
trapichear	trapicheo
ministrar	ministro
asociar	asocio
rasar	raso
filosofear	filosofeo
acerrojar	acerrojo
aposentar	aposento
baquiar	baquío
cavilar	cavilo
universalizar	universalizo
liquidar	liquido
embrujar	embrujo
campanillear	campanilleo
complejizar	complejizo
abreviar	abrevio
repreguntar	repregunto
desapalancar	desapalanco
expandir	expando
denunciar	denuncio
carretear	carreteo
cebar	cebo
devanar	devano
desalojar	desalojo
silenciar	silencio
habitar	habito
acitronar	acitrono
renegar	reniego
extremar	extremo
escatimar	escatimo
interpelar	interpelo
desdibujar	desdibujo
linear	lineo
envanecer	envanezco
facturar	facturo
territorializar	territorializo
aglutinar	aglutino
recocinar	recocino
ingeniar	ingenio
sonrosar	sonroso
alternar	alterno
derivar	derivo
resudar	resudo
chupetear	chupeteo
templar	templo
compensar	compenso
odiar	odio
acontecer	acontezco
esclarecer	esclarezco
aprestar	apresto
encasquillar	encasquillo
fechar	fecho
industrializar	industrializo
comunicar	comunico
recibir	recibo
atiesar	atieso
embrear	embreo
podrir	pudro
desembolsar	desembolso
debitar	debito
limitar	limito
conmover	conmuevo
zurrir	zurro
segmentar	segmento
adargar	adargo
difundir	difundo
agarrotar	agarroto
amaestrar	amaestro
machucar	machuco
augurar	auguro
sacralizar	sacralizo
traficar	trafico
chafar	chafo
acrecer	acrezco
deshuesar	deshueso
salinizar	salinizo
prodigar	prodigo
machacar	machaco
aguantar	aguanto
zozobrar	zozobro
hermosear	hermoseo
tejer	tejo
empatar	empato
sanear	saneo
entrecomillar	entrecomillo
cañonear	cañoneo
permitir	permito
confundir	confundo
precintar	precinto
hilar	hilo
desproveer	desproveo
charlar	charlo
grillar	grillo
encender	enciendo
deshilachar	deshilacho
desparpajar	desparpajo
realojar	realojo
lidiar	lidio
incurrir	incurro
sobreestimular	sobreestimulo
desertizar	desertizo
atenazar	atenazo
surtir	surto
palidecer	palidezco
descorchar	descorcho
desenmascarar	desenmascaro
militarizar	militarizo
santificar	santifico
acuatizar	acuatizo
deshelar	deshielo
avergonzar	avergüenzo
regentar	regento
bordar	bordo
nixtamalizar	nixtamalizo
delimitar	delimito
acorrer	acorro
inquirir	inquiero
digitar	digito
chisporrotear	chisporroteo
desemborrachar	desemborracho
rumorear	rumoreo
barajear	barajeo
insensibilizar	insensibilizo
enaltecer	enaltezco
fortalecer	fortalezco
atardecer	atardezco
tratar	trato
salar	salo
extasiar	extasío
tensionar	tensiono
desballestar	desballesto
estabiecer	estabieco
contorsionar	contorsiono
resembrar	resiembro
garantir	garanto
indizar	indizo
atreguar	atreguo
tachonar	tachono
supurar	supuro
exigir	exijo
sensibilizar	sensibilizo
diversificar	diversifico
despojar	despojo
remachar	remacho
caracterizar	caracterizo
regir	rijo
precaver	precavo
aguar	aguo
escarpar	escarpo
desentumecer	desentumezco
procesionar	procesiono
rojear	rojeo
discernir	discierno
fragilizar	fragilizo
encauzar	encauzo
avispar	avispo
impagar	impago
reconfortar	reconforto
agraciar	agracio
ondular	ondulo
cohabitar	cohabito
depender	dependo
desflorar	desfloro
desaviar	desavío
desechar	desecho
lancear	lanceo
entrechocar	entrechoco
diezmar	diezmo
antojar	antojo
encomendar	encomiendo
disciplinar	disciplino
computerizar	computerizo
editorializar	editorializo
chorear	choreo
rapiñar	rapiño
desenfrenar	desenfreno
contactar	contacto
delegar	delego
acribillar	acribillo
parar	paro
resoltar	resuelto
reintegrar	reintegro
graduar	gradúo
indexar	indexo
apadrinar	apadrino
contrademandar	contrademando
atusar	atuso
repentizar	repentizo
liar	lío
falsar	falso
guisar	guiso
surcar	surco
desamistar	desamisto
alijarar	alijaro
aborrecer	aborrezco
expatriar	expatrio
desabrochar	desabrocho
resituar	resitúo
redistribuir	redistribuo
encebollar	encebollo
desencallar	desencallo
atolondrar	atolondro
analizar	analizo
mercadear	mercadeo
desenclavar	desenclavo
descuerar	descuero
zangolotear	zangoloteo
subyugar	subyugo
encantar	encanto
sobreactuar	sobreactúo
autorreparar	autorreparo
jalear	jaleo
versear	verseo
suplir	suplo
racanear	racaneo
aterrorizar	aterrorizo
embaular	embaúlo
calafatear	calafateo
enfurecer	enfurezco
modificar	modifico
perfumar	perfumo
enjuagar	enjuago
esquematizar	esquematizo
pintarrajear	pintarrajeo
solicitar	solicito
empalidecer	empalidezco
supervalorar	supervaloro
adscribir	adscribo
despertar	despierto
ajusticiar	ajusticio
trotar	troto
trivializar	trivializo
impulsar	impulso
picotear	picoteo
fetichizar	fetichizo
arrebolar	arrebolo
adelantar	adelanto
reabastecer	reabastezco
olfatear	olfateo
aplomar	aplomo
exprimir	exprimo
realimentar	realimento
revestir	revisto
candar	cando
decidir	decido
fenecer	fenezco
hendir	hiendo
acezar	acezo
esprintar	esprinto
entreabrir	entreabro
desguazar	desguazo
desjarretar	desjarreto
trajinar	trajino
abrevar	abrevo
sofocar	sofoco
aplazar	aplazo
interrumpir	interrumpo
aminorar	aminoro
feminizar	feminizo
moldar	moldo
enseñorear	enseñoreo
arremolinar	arremolino
deslumbrar	deslumbro
colorar	coloro
rematar	remato
proclamar	proclamo
tender	tiendo
resolver	resuelvo
anchar	ancho
delinear	delineo
recalibrar	recalibro
obstar	obsto
apapachar	apapacho
conllevar	conllevo
sisear	siseo
holgazanear	holgazaneo
regazar	regazo
respirar	respiro
exhalar	exhalo
corroborar	corroboro
enmendar	enmiendo
parlamentar	parlamento
fresar	freso
reasumir	reasumo
tramitar	tramito
releer	releo
romanar	romano
deslegitimar	deslegitimo
vaporizar	vaporizo
suturar	suturo
fisionar	fisiono
sollozar	sollozo
hinchar	hincho
migar	migo
asegurar	aseguro
perdonar	perdono
cooperar	coopero
colonizar	colonizo
comisionar	comisiono
mascullar	mascullo
prorratear	prorrateo
ventilar	ventilo
wikificar	wikifico
chichar	chicho
achatar	achato
manducar	manduco
vallar	vallo
desvirtuar	desvirtúo
atragantar	atraganto
aceptar	acepto
explicitar	explicito
cellisquear	cellisqueo
hipnotizar	hipnotizo
desjudicializar	desjudicializo
masticar	mastico
obedecer	obedezco
catar	cato
maliciar	malicio
empelotar	empeloto
romanizar	romanizo
lastrar	lastro
determinar	determino
impactar	impacto
salmodiar	salmodio
recatar	recato
desconchar	desconcho
pudrir	pudro
adecentar	adecento
fanatizar	fanatizo
tañer	taño
enchilar	enchilo
regalonear	regaloneo
estampar	estampo
columbrar	columbro
colocar	coloco
divinizar	divinizo
superar	supero
reemprender	reemprendo
aplegar	apliego
tangar	tango
racionalizar	racionalizo
reemplazar	reemplazo
refutar	refuto
saciar	sacio
propender	propendo
condimentar	condimento
subir	subo
reinyectar	reinyecto
sincretizar	sincretizo
rubricar	rubrico
confirmar	confirmo
hambrear	hambreo
aplebeyar	aplebeyo
baladrar	baladro
convencer	convenzo
dormitar	dormito
agilipollar	agilipollo
puntualizar	puntualizo
avistar	avisto
promulgar	promulgo
automatizar	automatizo
ambular	ambulo
anillar	anillo
recambiar	recambio
externar	externo
inmortalizar	inmortalizo
azorar	azoro
caricaturar	caricaturo
autoeditar	autoedito
alumbrar	alumbro
refrotar	refroto
germanizar	germanizo
manuscribir	manuscribo
archivar	archivo
despedir	despido
suplementar	suplemento
reexpedir	reexpido
llegar	llego
proyectar	proyecto
antepagar	antepago
ligar	ligo
renquear	renqueo
enyesar	enyeso
constatar	constato
repisar	repiso
encajar	encajo
extralimitar	extralimito
amarillar	amarillo
gelatinizar	gelatinizo
acaparar	acaparo
compactar	compacto
destiñar	destiño
deletrear	deletreo
asentir	asiento
clavar	clavo
hipertrofiar	hipertrofio
calefaccionar	calefacciono
aquilatar	aquilato
fascinar	fascino
enfermar	enfermo
autocensurar	autocensuro
correlacionar	correlaciono
algodonar	algodono
contramandar	contramando
recortar	recorto
reflectar	reflecto
ametrallar	ametrallo
atrincherar	atrinchero
unir	uno
inculcar	inculco
sobrevendir	sobrevendo
amortiguar	amortiguo
revisionar	revisiono
sobrealzar	sobrealzo
restablecer	restablezco
vagar	vago
golpetear	golpeteo
conducir	conduzco
noticiar	noticio
progresar	progreso
agostar	agosto
cumplimentar	cumplimento
despolvar	despolvo
laicizar	laicizo
aviejar	aviejo
deslabonar	deslabono
aturrullar	aturrullo
preferir	prefiero
portar	porto
secularizar	secularizo
minimizar	minimizo
patrimonializar	patrimonializo
vaticinar	vaticino
confinar	confino
amacollar	amacollo
eviscerar	eviscero
pasteurizar	pasteurizo
carpir	carpo
dinamizar	dinamizo
virar	viro
medrar	medro
enjugar	enjugo
orar	oro
enquistar	enquisto
desbarrancar	desbarranco
tiranizar	tiranizo
rearmar	rearmo
premorir	premuero
descabellar	descabello
maridar	marido
diseccionar	disecciono
tardar	tardo
transcribir	transcribo
asturianizar	asturianizo
abanicar	abanico
hartar	harto
mayar	mayo
enchalecar	enchaleco
desclavar	desclavo
chorizar	chorizo
amojamar	amojamo
heredar	heredo
encoger	encojo
amenguar	amenguo
parchear	parcheo
revenir	revengo
abjurar	abjuro
nacer	nazco
desdeñar	desdeño
proscribir	proscribo
horrorizar	horrorizo
moderar	modero
fusilar	fusilo
testificar	testifico
digerir	digiero
azular	azulo
prensar	prenso
encalar	encalo
deslenguar	deslenguo
palar	palo
respingar	respingo
diligenciar	diligencio
despeluzar	despeluzo
musicalizar	musicalizo
escabullar	escabullo
reacondicionar	reacondiciono
palomar	palomo
amigar	amigo
chispear	chispeo
encasquetar	encasqueto
infringir	infrinjo
afinar	afino
humanar	humano
ingresar	ingreso
renguear	rengueo
espeluznar	espeluzno
desvalorizar	desvalorizo
agarbanzar	agarbanzo
arrellanar	arrellano
redirigir	redirijo
encamar	encamo
alambrar	alambro
ciberacosar	ciberacoso
amolar	amuelo
avanzar	avanzo
adaptar	adapto
rehacer	rehago
acomodar	acomodo
timar	timo
contonear	contoneo
enmarañar	enmaraño
empacar	empaco
ringar	ringo
transformar	transformo
introducir	introduzco
calcar	calco
reimprimir	reimprimo
descontrolar	descontrolo
vocear	voceo
estofar	estofo
descabalar	descabalo
acantorar	acantoro
emprender	emprendo
reimpulsar	reimpulso
peraltar	peralto
cariciar	caricio
importunar	importuno
auditar	audito
cosificar	cosifico
desaforar	desafuero
espiritualizar	espiritualizo
mugir	mujo
desalmar	desalmo
malgastar	malgasto
encunar	encuno
retirar	retiro
abaluartar	abaluarto
plantar	planto
enroscar	enrosco
cotillear	cotilleo
placar	placo
seglar	seglo
faxear	faxeo
balizar	balizo
demudar	demudo
ponderar	pondero
desvestir	desvisto
sellar	sello
gasear	gaseo
descreer	descreo
despostillar	despostillo
aturdir	aturdo
guiar	guío
dragar	drago
medir	mido
descalificar	descalifico
arrojar	arrojo
serpentear	serpenteo
pescuecear	pescueceo
tremer	tremo
incapacitar	incapacito
involucrar	involucro
formalizar	formalizo
brillar	brillo
angustiar	angustio
inseminar	insemino
reenergizar	reenergizo
empotrar	empotro
acampar	acampo
acarrear	acarreo
percatar	percato
regenerar	regenero
engarruchar	engarrucho
eyectar	eyecto
paladear	paladeo
debilitar	debilito
corporizar	corporizo
canjear	canjeo
descabalgar	descabalgo
sobrevalorar	sobrevaloro
impacientar	impaciento
desnatar	desnato
desbloquear	desbloqueo
meter	meto
multicopiar	multicopio
bailotear	bailoteo
desarreglar	desarreglo
reubicar	reubico
tusar	tuso
remozar	remozo
aluzar	aluzo
descontentar	descontento
perfilar	perfilo
malfuncionar	malfunciono
decolorar	decoloro
diptongar	diptongo
difuminar	difumino
deshabitar	deshabito
asomar	asomo
martillear	martilleo
sobrepasar	sobrepaso
jubilar	jubilo
esclerosar	escleroso
inmunizar	inmunizo
enviciar	envicio
murar	muro
escuchar	escucho
limosnear	limosneo
inspirar	inspiro
repiquetear	repiqueteo
biselar	biselo
opacar	opaco
cotizar	cotizo
retemblar	retiemblo
favorecer	favorezco
ofertar	oferto
teñir	tiño
pajarear	pajareo
derramar	derramo
destilar	destilo
abarrar	abarro
operar	opero
vosear	voseo
hozar	hozo
obispar	obispo
amotinar	amotino
manifestar	manifiesto
juntar	junto
zafar	zafo
alborozar	alborozo
rebosar	reboso
procesar	proceso
fisgonear	fisgoneo
enfervorizar	enfervorizo
irrumpir	irrumpo
amoscar	amosco
discursear	discurseo
acolchar	acolcho
zampar	zampo
autofinanciar	autofinancio
aprovisionar	aprovisiono
compatibilizar	compatibilizo
airar	aíro
detonar	detono
topear	topeo
inventariar	inventarío
sancionar	sanciono
exorbitar	exorbito
repartir	reparto
resbalar	resbalo
desendeudar	desendeudo
acusar	acuso
especular	especulo
remediar	remedio
empodrecer	empodrezco
divergir	diverjo
recargar	recargo
solapar	solapo
esforzar	esfuerzo
entelar	entelo
franelear	franeleo
infeccionar	infecciono
encolerizar	encolerizo
efectuar	efectúo
encuartelar	encuartelo
emancipar	emancipo
abastionar	abastiono
simular	simulo
bolsear	bolseo
remirar	remiro
indisciplinar	indisciplino
desconsiderar	desconsidero
becar	beco
arrogar	arrogo
clocar	clueco
macollar	macollo
rebullir	rebullo
holografiar	holografío
avecinar	avecino
reincidir	reincido
boxear	boxeo
catolizar	catolizo
demediar	demedio
encubrir	encubro
concentrar	concentro
encristalar	encristalo
subsanar	subsano
condicionar	condiciono
solucionar	soluciono
develar	develo
aerografiar	aerografío
despedazar	despedazo
revalidar	revalido
reportar	reporto
errar	yerro
guitarrear	guitarreo
seccionar	secciono
encabestrar	encabestro
imposibilitar	imposibilito
dignificar	dignifico
regimentar	regimiento
calificar	califico
empezar	empiezo
empecinar	empecino
vulnerar	vulnero
bisecar	biseco
potabilizar	potabilizo
inquietar	inquieto
encalabozar	encalabozo
colgar	cuelgo
exultar	exulto
alelar	alelo
sanitizar	sanitizo
distanciar	distancio
quebrar	quiebro
masculinizar	masculinizo
corregir	corrijo
pulsar	pulso
rezar	rezo
escoplear	escopleo
emborronar	emborrono
decantar	decanto
enflacar	enflaco
desagregar	desagrego
salpicar	salpico
aureolar	aureolo
regatear	regateo
optimizar	optimizo
planificar	planifico
reformatear	reformateo
incidir	incido
afianzar	afianzo
eligir	elijo
desalentar	desaliento
desvainar	desvaino
tronchar	troncho
acuciar	acucio
trabucar	trabuco
restringir	restrinjo
soñar	sueño
retrogradar	retrogrado
quemar	quemo
despechugar	despechugo
capacitar	capacito
reconciliar	reconcilio
comprar	compro
cariar	carío
radicalizar	radicalizo
añorar	añoro
prorrumpir	prorrumpo
asalariar	asalario
remezclar	remezclo
rebasar	rebaso
sablear	sableo
tincar	tinco
autoanular	autoanulo
debelar	debelo
xerocopiar	xerocopio
escobar	escobo
engatar	engato
olear	oleo
comenzar	comienzo
desescalar	desescalo
maullar	maúllo
converger	converjo
concebir	concibo
despatarrar	despatarro
metodizar	metodizo
entorpecer	entorpezco
avizorar	avizoro
trincar	trinco
congestionar	congestiono
contrarrestar	contrarresto
embanderar	embandero
derogar	derogo
totalizar	totalizo
morigerar	morigero
soler	suelo
realinear	realíneo
encausar	encauso
migrar	migro
adelgazar	adelgazo
dispersar	disperso
convergir	converjo
erigir	erijo
retractar	retracto
copatrocinar	copatrocino
fosforescer	fosforesco
desatender	desatiendo
reentrar	reentro
desasistir	desasisto
librar	libro
reprogramar	reprogramo
atosigar	atosigo
brutalizar	brutalizo
amortizar	amortizo
amorrar	amorro
resondrar	resondro
festinar	festino
recapturar	recapturo
recontar	recuento
destejer	destejo
atesar	atieso
reprehender	reprehendo
ladrar	ladro
empañar	empaño
enramar	enramo
rediseñar	rediseño
concienciar	conciencio
entremeter	entremeto
infestar	infesto
arrugar	arrugo
eliminar	elimino
vender	vendo
tajar	tajo
gobernar	gobierno
traquetear	traqueteo
existir	existo
guillotinar	guillotino
rusificar	rusifico
bajar	bajo
oxidar	oxido
compadrear	compadreo
destocar	destoco
culminar	culmino
represar	represo
enterar	entero
hidrolizar	hidrolizo
empecer	empezco
pertrechar	pertrecho
demeritar	demerito
examinar	examino
desmantelar	desmantelo
aporrear	aporreo
guadañar	guadaño
utilizar	utilizo
gratificar	gratifico
enmohecer	enmohezco
leer	leo
fastidiar	fastidio
multiplicar	multiplico
formar	formo
dulcificar	dulcifico
internalizar	internalizo
idolatrar	idolatro
pensar	pienso
aprender	aprendo
voltear	volteo
callar	callo
tramar	tramo
alimentar	alimento
marrar	marro
vulgarizar	vulgarizo
sublevar	sublevo
caracolear	caracoleo
culiar	culeo
bramar	bramo
usufructuar	usufructúo
sobresaltar	sobresalto
esposar	esposo
desmovilizar	desmovilizo
pactar	pacto
certificar	certifico
enloquecer	enloquezco
rayar	rayo
evadir	evado
forzar	fuerzo
derribar	derribo
comandar	comando
yapar	yapo
emponzoñar	emponzoño
excrementar	excremento
parir	paro
reforzar	refuerzo
gilipollear	gilipolleo
enderezar	enderezo
desajustar	desajusto
retrasar	retraso
coincidir	coincido
engominar	engomino
mimetizar	mimetizo
repostar	reposto
espiar	espío
encrespar	encrespo
abatojar	abatojo
menstruar	menstrúo
penitenciar	penitencio
clausurar	clausuro
vanagloriar	vanaglorio
principiar	principio
administrar	administro
desentrañar	desentraño
alocar	aloco
evolucionar	evoluciono
repatear	repateo
hormiguear	hormigueo
motorizar	motorizo
tergiversar	tergiverso
apropiar	apropio
turquear	turqueo
desorientar	desoriento
suplicar	suplico
cachondear	cachondeo
zancajear	zancajeo
desmentir	desmiento
heder	hiedo
opugnar	opugno
centuplicar	centuplico
preñar	preño
lesionar	lesiono
fundar	fundo
desencantar	desencanto
tundir	tundo
competir	compito
lonchear	loncheo
compendiar	compendio
reusar	reuso
croar	croo
anular	anulo
desatornillar	desatornillo
apanar	apano
perder	pierdo
escuadrar	escuadro
interconectar	interconecto
abadernar	abaderno
pelar	pelo
sajar	sajo
acidificar	acidifico
cristianar	cristiano
infiltrar	infiltro
ovular	ovulo
amanerar	amanero
pivotear	pivoteo
recristalizar	recristalizo
tunear	tuneo
desensimismar	desensimismo
rotular	rotulo
escuadronar	escuadrono
postergar	postergo
remoldear	remoldeo
cablear	cableo
despechar	despecho
sobrepujar	sobrepujo
bostezar	bostezo
ronzar	ronzo
reelaborar	reelaboro
entristecer	entristezco
aguzar	aguzo
gandujar	gandujo
ahondar	ahondo
levantar	levanto
erosionar	erosiono
descoordinar	descoordino
pendejear	pendejeo
reir	río
renegociar	renegocio
atar	ato
aborregar	aborrego
evitar	evito
acariciar	acaricio
disputar	disputo
interpenetrar	interpenetro
regular	regulo
prescindir	prescindo
sentir	siento
imprimir	imprimo
lanzar	lanzo
sembrar	siembro
merecer	merezco
clorar	cloro
amilanar	amilano
trasmudar	trasmudo
patinar	patino
plasmar	plasmo
guachapear	guachapeo
desmadrar	desmadro
piquetear	piqueteo
despelotar	despeloto
reclutar	recluto
emulsionar	emulsiono
desdecir	desdigo
eternizar	eternizo
obstinar	obstino
tormentar	tormento
reimplantar	reimplanto
cargar	cargo
desdoblar	desdoblo
comercializar	comercializo
encuadrar	encuadro
marginar	margino
sermonear	sermoneo
coaccionar	coacciono
empajar	empajo
golear	goleo
descuartizar	descuartizo
atontar	atonto
revalorar	revaloro
italianizar	italianizo
redar	redo
hocicar	hocico
economizar	economizo
mascujar	mascujo
justar	justo
balbucear	balbuceo
extenuar	extenúo
discontinuar	discontinúo
transfigurar	transfiguro
reencontrar	reencuentro
arietar	arieto
pigmentar	pigmento
empinar	empino
ralentizar	ralentizo
posesionar	posesiono
mandrilar	mandrilo
varear	vareo
intelectualizar	intelectualizo
enlutar	enluto
tabletear	tableteo
florecer	florezco
escenificar	escenifico
renunciar	renuncio
enchufar	enchufo
sonsacar	sonsaco
cornear	corneo
asolar	asuelo
alborotar	alboroto
telegrafiar	telegrafío
repostular	repostulo
testiguar	testiguo
cuidar	cuido
alechugar	alechugo
titilar	titilo
interferir	interfiero
refigurar	refiguro
recriminar	recrimino
empanar	empano
tantear	tanteo
desplacer	desplazco
obsequiar	obsequio
copiar	copio
empantanar	empantano
fatigar	fatigo
buscar	busco
masturbar	masturbo
compadecer	compadezco
desenredar	desenredo
revelar	revelo
defecar	defeco
descriminalizar	descriminalizo
designar	designo
referenciar	referencio
endeudar	endeudo
vacacionar	vacaciono
cachetear	cacheteo
pillar	pillo
erguir	yergo
escarbar	escarbo
aquejar	aquejo
explanar	explano
apisonar	apisono
doblegar	doblego
crispar	crispo
defender	defiendo
agravar	agravo
adherir	adhiero
iniciar	inicio
enserar	ensero
aprontar	apronto
efectivizar	efectivizo
misar	miso
perquirir	perquiero
claudicar	claudico
remorder	remuerdo
retornar	retorno
resacar	resaco
fabular	fabulo
expurgar	expurgo
ajuntar	ajunto
tomar	tomo
reestructurar	reestructuro
desconvocar	desconvoco
quebrantar	quebranto
infamar	infamo
apuñalar	apuñalo
malentender	malentiendo
azucarar	azucaro
ennoblecer	ennoblezco
ocasionar	ocasiono
menudear	menudeo
bosquejar	bosquejo
engalanar	engalano
aportar	aporto
hostigar	hostigo
emboscar	embosco
bichar	bicho
desbaratar	desbarato
pesquisar	pesquiso
azuzar	azuzo
aberrar	aberro
ludir	ludo
amacizar	amacizo
trasladar	traslado
enlucir	enluzco
fallar	fallo
reunir	reúno
contender	contiendo
escavar	escavo
estebar	estebo
medicinar	medicino
destellar	destello
escudar	escudo
malversar	malverso
embridar	embrido
metabolizar	metabolizo
urgir	urjo
encelar	encelo
signar	signo
corresponder	correspondo
cansar	canso
driblar	driblo
ladrillar	ladrillo
encarar	encaro
tintinear	tintineo
autoengañar	autoengaño
sobrecoger	sobrecojo
desvirgar	desvirgo
cosechar	cosecho
alarmar	alarmo
refundir	refundo
mostrar	muestro
resignar	resigno
pacer	pazco
poblar	pueblo
laxar	laxo
amedrentar	amedrento
subyacer	subyazco
prologar	prologo
acequiar	acequio
verberar	verbero
interactuar	interactúo
parafrasear	parafraseo
brumar	brumo
macular	maculo
amistar	amisto
desperezar	desperezo
afeminar	afemino
dirigir	dirijo
ritualizar	ritualizo
cardar	cardo
vivar	vivo
destacar	destaco
rebrillar	rebrillo
englosar	engloso
disculpar	disculpo
congraciar	congracio
mentorizar	mentorizo
carburar	carburo
perjudicar	perjudico
desarropar	desarropo
ilegalizar	ilegalizo
inutilizar	inutilizo
levigar	levigo
repasar	repaso
presurizar	presurizo
gorrear	gorreo
diagnosticar	diagnostico
funcionar	funciono
sondar	sondo
pipar	pipo
pisar	piso
amoratar	amorato
arrebozar	arrebozo
coludir	coludo
recalcular	recalculo
rascar	rasco
carburizar	carburizo
arredrar	arredro
espolvear	espolveo
reformar	reformo
equiparar	equiparo
señalizar	señalizo
obscurecer	obscurezco
seducir	seduzco
terraplenar	terrapleno
taquear	taqueo
enronquecer	enronquezco
descarriar	descarrío
ofrendar	ofrendo
espolear	espoleo
descontaminar	descontamino
helenizar	helenizo
abultar	abulto
sustentar	sustento
excavar	excavo
contrabalancear	contrabalanceo
convalecer	convalezco
discriminar	discrimino
enraizar	enraízo
enturbiar	enturbio
extirpar	extirpo
revisar	reviso
peer	peo
catapultar	catapulto
desabrir	desabro
suministrar	suministro
plebiscitar	plebiscito
sobrellevar	sobrellevo
retomar	retomo
stalkear	stalkeo
entrañar	entraño
jorobar	jorobo
uniformizar	uniformizo
florear	floreo
asfixiar	asfixio
subestimar	subestimo
amaitinar	amaitino
guerrear	guerreo
encuestar	encuesto
escenografiar	escenografío
amedrantar	amedranto
fondear	fondeo
entresacar	entresaco
matrimoniar	matrimonio
descomedir	descomido
reorganizar	reorganizo
sistemar	sistemo
empollar	empollo
evaporar	evaporo
protestar	protesto
trasnochar	trasnocho
circunstanciar	circunstancio
endomingar	endomingo
coordinar	coordino
instar	insto
estilizar	estilizo
maravillar	maravillo
abarloar	abarloo
desvelar	desvelo
deconstruir	deconstruyo
empobrecer	empobrezco
recuadrar	recuadro
desbridar	desbrido
recalificar	recalifico
cantar	canto
responsabilizar	responsabilizo
refrigerar	refrigero
vetar	veto
tontear	tonteo
regoldar	regüeldo
profetizar	profetizo
preludiar	preludio
glasear	glaseo
desabastecer	desabastezco
recolocar	recoloco
yacer	yazco
consolidar	consolido
conculcar	conculco
carpintear	carpinteo
mimar	mimo
aparar	aparo
precaucionar	precauciono
sobrenadar	sobrenado
empuñar	empuño
originar	origino
encapuchar	encapucho
refundamentar	refundamento
digitalizar	digitalizo
legislar	legislo
enarcar	enarco
psicoanalizar	psicoanalizo
enrolar	enrolo
desocupar	desocupo
ensombrecer	ensombrezco
resorber	resorbo
abancalar	abancalo
aplacer	aplazco
descentralizar	descentralizo
prejuzgar	prejuzgo
enjuncar	enjunco
obsesionar	obsesiono
intercambiar	intercambio
empaquetar	empaqueto
transfundir	transfundo
buitrear	buitreo
convertir	convierto
obliterar	oblitero
relanzar	relanzo
sorber	sorbo
engolosinar	engolosino
clasificar	clasifico
sobreimpresionar	sobreimpresiono
rechinar	rechino
redibujar	redibujo
enfardar	enfardo
ulcerar	ulcero
acotar	acoto
retitular	retitulo
cloquear	cloqueo
malear	maleo
entreverar	entrevero
congregar	congrego
estirazar	estirazo
perjurar	perjuro
retroalimentar	retroalimento
pandear	pandeo
tallar	tallo
intercalar	intercalo
calumniar	calumnio
improvisar	improviso
aprehender	aprehendo
astreñir	astriño
soslayar	soslayo
cagar	cago
embolsillar	embolsillo
agitanar	agitano
emborrachar	emborracho
rajuñar	rajuño
relinchar	relincho
reivindicar	reivindico
indignar	indigno
remeter	remeto
blandir	blando
ratificar	ratifico
problematizar	problematizo
enlodar	enlodo
halar	halo
balear	baleo
resellar	resello
acalmar	acalmo
rebotar	reboto
desertar	deserto
abocar	aboco
garrar	garro
restar	resto
elevar	elevo
topar	topo
despeinar	despeino
microanalizar	microanalizo
deslocalizar	deslocalizo
apalabrar	apalabro
dimitir	dimito
patentizar	patentizo
abroncar	abronco
humidificar	humidifico
engordar	engordo
auxiliar	auxilio
jalar	jalo
mentar	miento
tragar	trago
enfrescar	enfresco
zurcir	zurzo
insinuar	insinúo
comprobar	compruebo
contratar	contrato
rogar	ruego
transportar	transporto
recorrer	recorro
rollar	rollo
endilgar	endilgo
diputar	diputo
burlar	burlo
remodelar	remodelo
